,NAME,Workers - Commute Method,Work From Home,Proportion Work From Home,Workers - Commute Length,Median Commute Length,TractCode
0,"Census Tract 114.13, Hamilton County, Tennessee",4078,201,4.93,3877,29.59,47065011413
1,"Census Tract 9502, Hardeman County, Tennessee",921,38,4.13,883,37.32,47069950200
2,"Census Tract 9504, Hardeman County, Tennessee",2077,61,2.94,2016,33.13,47069950400
3,"Census Tract 9501, Hardeman County, Tennessee",1431,77,5.38,1354,38.87,47069950100
4,"Census Tract 9505, Hardeman County, Tennessee",1476,94,6.37,1382,39.44,47069950500
5,"Census Tract 9506, Hardeman County, Tennessee",730,19,2.6,711,42.32,47069950600
6,"Census Tract 1101, Morgan County, Tennessee",1006,19,1.89,987,33.21,47129110100
7,"Census Tract 1105, Morgan County, Tennessee",1691,67,3.96,1624,37.24,47129110500
8,"Census Tract 1103, Morgan County, Tennessee",1465,38,2.59,1427,33.35,47129110300
9,"Census Tract 1104, Morgan County, Tennessee",1587,73,4.6,1514,32.77,47129110400
10,"Census Tract 1102, Morgan County, Tennessee",1281,16,1.25,1265,44.26,47129110200
11,"Census Tract 9550, Grundy County, Tennessee",821,68,8.28,753,34.24,47061955000
12,"Census Tract 9553, Grundy County, Tennessee",1883,138,7.33,1745,33.98,47061955300
13,"Census Tract 9551, Grundy County, Tennessee",513,27,5.26,486,27.39,47061955100
14,"Census Tract 9552, Grundy County, Tennessee",1454,83,5.71,1371,41.44,47061955200
15,"Census Tract 9690, Henry County, Tennessee",1387,78,5.62,1309,33.21,47079969000
16,"Census Tract 9691, Henry County, Tennessee",1279,49,3.83,1230,28.55,47079969100
17,"Census Tract 9693, Henry County, Tennessee",1056,98,9.28,958,17.46,47079969300
18,"Census Tract 9695, Henry County, Tennessee",2176,48,2.21,2128,18.0,47079969500
19,"Census Tract 9696, Henry County, Tennessee",3280,98,2.99,3182,22.73,47079969600
20,"Census Tract 9697, Henry County, Tennessee",611,37,6.06,574,31.22,47079969700
21,"Census Tract 9692, Henry County, Tennessee",769,71,9.23,698,28.37,47079969200
22,"Census Tract 9698, Henry County, Tennessee",979,12,1.23,967,28.5,47079969800
23,"Census Tract 9694, Henry County, Tennessee",734,5,0.68,729,21.06,47079969400
24,"Census Tract 9801, Cocke County, Tennessee",0,0,,0,0.0,47029980100
25,"Census Tract 604, Loudon County, Tennessee",1869,176,9.42,1693,32.47,47105060400
26,"Census Tract 9610, Crockett County, Tennessee",887,46,5.19,841,30.92,47033961000
27,"Census Tract 9613, Crockett County, Tennessee",970,8,0.82,962,31.38,47033961300
28,"Census Tract 9503, Hardeman County, Tennessee",1242,56,4.51,1186,28.63,47069950300
29,"Census Tract 607, Loudon County, Tennessee",1154,79,6.85,1075,30.67,47105060700
30,"Census Tract 601, Loudon County, Tennessee",2316,37,1.6,2279,28.2,47105060100
31,"Census Tract 606, Loudon County, Tennessee",2125,66,3.11,2059,25.6,47105060600
32,"Census Tract 9503, Polk County, Tennessee",1532,68,4.44,1464,35.1,47139950300
33,"Census Tract 9504, Polk County, Tennessee",1413,18,1.27,1395,25.14,47139950400
34,"Census Tract 8, Shelby County, Tennessee",643,42,6.53,601,29.07,47157000800
35,"Census Tract 13, Shelby County, Tennessee",1066,56,5.25,1010,28.28,47157001300
36,"Census Tract 14, Shelby County, Tennessee",682,6,0.88,676,28.41,47157001400
37,"Census Tract 15, Shelby County, Tennessee",640,22,3.44,618,26.8,47157001500
38,"Census Tract 17, Shelby County, Tennessee",2193,55,2.51,2138,23.78,47157001700
39,"Census Tract 21, Shelby County, Tennessee",466,41,8.8,425,29.53,47157002100
40,"Census Tract 31, Shelby County, Tennessee",2215,95,4.29,2120,21.07,47157003100
41,"Census Tract 39, Shelby County, Tennessee",671,9,1.34,662,19.35,47157003900
42,"Census Tract 42, Shelby County, Tennessee",2335,80,3.43,2255,23.61,47157004200
43,"Census Tract 46, Shelby County, Tennessee",582,21,3.61,561,23.42,47157004600
44,"Census Tract 53, Shelby County, Tennessee",900,0,0.0,900,29.46,47157005300
45,"Census Tract 63, Shelby County, Tennessee",1727,66,3.82,1661,22.62,47157006300
46,"Census Tract 65, Shelby County, Tennessee",915,24,2.62,891,22.35,47157006500
47,"Census Tract 71, Shelby County, Tennessee",1301,13,1.0,1288,23.36,47157007100
48,"Census Tract 1, Shelby County, Tennessee",3619,52,1.44,3567,22.3,47157000100
49,"Census Tract 97, Shelby County, Tennessee",1107,19,1.72,1088,27.86,47157009700
50,"Census Tract 78.22, Shelby County, Tennessee",560,8,1.43,552,24.86,47157007822
51,"Census Tract 80, Shelby County, Tennessee",2105,0,0.0,2105,21.87,47157008000
52,"Census Tract 102.10, Shelby County, Tennessee",2113,13,0.62,2100,24.66,47157010210
53,"Census Tract 802, Robertson County, Tennessee",3091,128,4.14,2963,38.39,47147080200
54,"Census Tract 804.01, Robertson County, Tennessee",2104,0,0.0,2104,29.79,47147080401
55,"Census Tract 805, Robertson County, Tennessee",2234,38,1.7,2196,33.39,47147080500
56,"Census Tract 804.02, Robertson County, Tennessee",1961,94,4.79,1867,28.94,47147080402
57,"Census Tract 801.01, Robertson County, Tennessee",2283,95,4.16,2188,45.63,47147080101
58,"Census Tract 807, Robertson County, Tennessee",3597,350,9.73,3247,40.96,47147080700
59,"Census Tract 9601, Franklin County, Tennessee",1451,14,0.96,1437,28.97,47051960100
60,"Census Tract 9608, Franklin County, Tennessee",1604,38,2.37,1566,34.66,47051960800
61,"Census Tract 9604, Franklin County, Tennessee",3482,71,2.04,3411,29.18,47051960400
62,"Census Tract 9606, Franklin County, Tennessee",1819,12,0.66,1807,29.77,47051960600
63,"Census Tract 9605, Franklin County, Tennessee",1369,27,1.97,1342,25.8,47051960500
64,"Census Tract 9607, Franklin County, Tennessee",1683,96,5.7,1587,22.01,47051960700
65,"Census Tract 9603, Franklin County, Tennessee",1183,13,1.1,1170,35.21,47051960300
66,"Census Tract 104, Blount County, Tennessee",1631,75,4.6,1556,25.71,47009010400
67,"Census Tract 111.02, Blount County, Tennessee",3825,72,1.88,3753,25.92,47009011102
68,"Census Tract 105, Blount County, Tennessee",1154,24,2.08,1130,22.08,47009010500
69,"Census Tract 102, Blount County, Tennessee",2806,104,3.71,2702,27.22,47009010200
70,"Census Tract 116.02, Blount County, Tennessee",4386,272,6.2,4114,34.57,47009011602
71,"Census Tract 101, Blount County, Tennessee",1117,0,0.0,1117,29.26,47009010100
72,"Census Tract 106, Blount County, Tennessee",1715,69,4.02,1646,22.1,47009010600
73,"Census Tract 109, Blount County, Tennessee",2747,133,4.84,2614,27.47,47009010900
74,"Census Tract 108, Blount County, Tennessee",1305,33,2.53,1272,21.85,47009010800
75,"Census Tract 107, Blount County, Tennessee",2375,136,5.73,2239,26.21,47009010700
76,"Census Tract 111.01, Blount County, Tennessee",2326,22,0.95,2304,29.42,47009011101
77,"Census Tract 110.20, Shelby County, Tennessee",674,0,0.0,674,24.08,47157011020
78,"Census Tract 205.11, Shelby County, Tennessee",1150,18,1.57,1132,25.57,47157020511
79,"Census Tract 207, Shelby County, Tennessee",1002,40,3.99,962,35.74,47157020700
80,"Census Tract 212, Shelby County, Tennessee",0,0,,0,0.0,47157021200
81,"Census Tract 208.20, Shelby County, Tennessee",4286,171,3.99,4115,31.4,47157020820
82,"Census Tract 211.35, Shelby County, Tennessee",3362,14,0.42,3348,30.09,47157021135
83,"Census Tract 214.10, Shelby County, Tennessee",1376,98,7.12,1278,23.75,47157021410
84,"Census Tract 217.53, Shelby County, Tennessee",1659,0,0.0,1659,26.1,47157021753
85,"Census Tract 223.10, Shelby County, Tennessee",1611,0,0.0,1611,33.51,47157022310
86,"Census Tract 223.22, Shelby County, Tennessee",1778,0,0.0,1778,28.99,47157022322
87,"Census Tract 224.10, Shelby County, Tennessee",2183,49,2.24,2134,31.6,47157022410
88,"Census Tract 7, Shelby County, Tennessee",1619,4,0.25,1615,27.31,47157000700
89,"Census Tract 11, Shelby County, Tennessee",1192,0,0.0,1192,28.33,47157001100
90,"Census Tract 19, Shelby County, Tennessee",447,0,0.0,447,28.82,47157001900
91,"Census Tract 32, Shelby County, Tennessee",2068,94,4.55,1974,20.67,47157003200
92,"Census Tract 28, Shelby County, Tennessee",834,10,1.2,824,29.59,47157002800
93,"Census Tract 43, Shelby County, Tennessee",1603,111,6.92,1492,26.66,47157004300
94,"Census Tract 58, Shelby County, Tennessee",266,0,0.0,266,35.67,47157005800
95,"Census Tract 68, Shelby County, Tennessee",790,31,3.92,759,41.83,47157006800
96,"Census Tract 74, Shelby County, Tennessee",1777,20,1.13,1757,21.9,47157007400
97,"Census Tract 79, Shelby County, Tennessee",2145,0,0.0,2145,22.31,47157007900
98,"Census Tract 92, Shelby County, Tennessee",3873,155,4.0,3718,22.89,47157009200
99,"Census Tract 95, Shelby County, Tennessee",3256,133,4.08,3123,23.69,47157009500
100,"Census Tract 205.12, Shelby County, Tennessee",2211,57,2.58,2154,23.37,47157020512
101,"Census Tract 96, Shelby County, Tennessee",2599,99,3.81,2500,20.56,47157009600
102,"Census Tract 108.20, Shelby County, Tennessee",2252,37,1.64,2215,20.92,47157010820
103,"Census Tract 209, Shelby County, Tennessee",5018,230,4.58,4788,36.01,47157020900
104,"Census Tract 217.10, Shelby County, Tennessee",1515,22,1.45,1493,26.13,47157021710
105,"Census Tract 217.24, Shelby County, Tennessee",1237,9,0.73,1228,24.56,47157021724
106,"Census Tract 112, Blount County, Tennessee",3883,82,2.11,3801,25.31,47009011200
107,"Census Tract 701.02, Cheatham County, Tennessee",1874,69,3.68,1805,43.54,47021070102
108,"Census Tract 703, Cheatham County, Tennessee",1460,0,0.0,1460,39.87,47021070300
109,"Census Tract 704, Carter County, Tennessee",685,16,2.34,669,29.34,47019070400
110,"Census Tract 706, Carter County, Tennessee",909,33,3.63,876,22.74,47019070600
111,"Census Tract 711, Carter County, Tennessee",725,45,6.21,680,25.97,47019071100
112,"Census Tract 717, Carter County, Tennessee",1517,23,1.52,1494,37.87,47019071700
113,"Census Tract 701, Carter County, Tennessee",508,21,4.13,487,21.45,47019070100
114,"Census Tract 702, Carter County, Tennessee",1639,95,5.8,1544,20.42,47019070200
115,"Census Tract 712, Carter County, Tennessee",1409,62,4.4,1347,25.93,47019071200
116,"Census Tract 703, Carter County, Tennessee",2056,70,3.4,1986,22.64,47019070300
117,"Census Tract 715, Carter County, Tennessee",603,15,2.49,588,36.46,47019071500
118,"Census Tract 713, Carter County, Tennessee",3349,166,4.96,3183,33.99,47019071300
119,"Census Tract 710, Carter County, Tennessee",1100,34,3.09,1066,19.74,47019071000
120,"Census Tract 707, Carter County, Tennessee",1620,26,1.6,1594,31.22,47019070700
121,"Census Tract 708, Carter County, Tennessee",1294,49,3.79,1245,25.44,47019070800
122,"Census Tract 714, Carter County, Tennessee",1324,20,1.51,1304,33.17,47019071400
123,"Census Tract 716, Carter County, Tennessee",502,31,6.18,471,40.94,47019071600
124,"Census Tract 709, Carter County, Tennessee",1672,96,5.74,1576,20.36,47019070900
125,"Census Tract 705, Carter County, Tennessee",1648,116,7.04,1532,32.92,47019070500
126,"Census Tract 5002, Grainger County, Tennessee",2325,87,3.74,2238,41.32,47057500200
127,"Census Tract 5003, Grainger County, Tennessee",2581,223,8.64,2358,38.14,47057500300
128,"Census Tract 5001, Grainger County, Tennessee",1661,90,5.42,1571,48.04,47057500100
129,"Census Tract 217.52, Shelby County, Tennessee",2550,28,1.1,2522,32.15,47157021752
130,"Census Tract 217.54, Shelby County, Tennessee",2026,90,4.44,1936,25.64,47157021754
131,"Census Tract 501, Lauderdale County, Tennessee",438,20,4.57,418,40.41,47097050100
132,"Census Tract 506, Lauderdale County, Tennessee",847,18,2.13,829,29.03,47097050600
133,"Census Tract 502, Lauderdale County, Tennessee",1275,0,0.0,1275,29.64,47097050200
134,"Census Tract 503, Lauderdale County, Tennessee",1166,16,1.37,1150,37.33,47097050300
135,"Census Tract 504, Lauderdale County, Tennessee",1242,23,1.85,1219,32.44,47097050400
136,"Census Tract 9606, Lawrence County, Tennessee",771,45,5.84,726,41.35,47099960600
137,"Census Tract 9601, Lawrence County, Tennessee",1423,11,0.77,1412,40.4,47099960100
138,"Census Tract 9609, Lawrence County, Tennessee",784,9,1.15,775,43.45,47099960900
139,"Census Tract 9603, Lawrence County, Tennessee",1860,152,8.17,1708,29.75,47099960300
140,"Census Tract 9602, Lawrence County, Tennessee",959,30,3.13,929,36.7,47099960200
141,"Census Tract 9607, Lawrence County, Tennessee",1622,20,1.23,1602,33.84,47099960700
142,"Census Tract 9608, Lawrence County, Tennessee",1417,25,1.76,1392,33.62,47099960800
143,"Census Tract 1, Madison County, Tennessee",1548,72,4.65,1476,19.24,47113000100
144,"Census Tract 5, Madison County, Tennessee",1072,9,0.84,1063,21.17,47113000500
145,"Census Tract 7, Madison County, Tennessee",832,35,4.21,797,24.79,47113000700
146,"Census Tract 11, Madison County, Tennessee",302,0,0.0,302,19.15,47113001100
147,"Census Tract 14.02, Madison County, Tennessee",1079,47,4.36,1032,27.08,47113001402
148,"Census Tract 15.02, Madison County, Tennessee",2549,57,2.24,2492,27.57,47113001502
149,"Census Tract 16.05, Madison County, Tennessee",1277,90,7.05,1187,16.44,47113001605
150,"Census Tract 16.06, Madison County, Tennessee",5358,81,1.51,5277,21.9,47113001606
151,"Census Tract 16.09, Madison County, Tennessee",811,27,3.33,784,25.58,47113001609
152,"Census Tract 17, Madison County, Tennessee",635,12,1.89,623,22.29,47113001700
153,"Census Tract 8, Madison County, Tennessee",351,5,1.42,346,19.97,47113000800
154,"Census Tract 9, Madison County, Tennessee",633,0,0.0,633,24.28,47113000900
155,"Census Tract 9611, Crockett County, Tennessee",1536,0,0.0,1536,24.16,47033961100
156,"Census Tract 9612, Crockett County, Tennessee",814,14,1.72,800,35.11,47033961200
157,"Census Tract 9614, Crockett County, Tennessee",1770,46,2.6,1724,29.98,47033961400
158,"Census Tract 9602, Lake County, Tennessee",996,36,3.61,960,25.33,47095960200
159,"Census Tract 9601, Lake County, Tennessee",908,0,0.0,908,23.3,47095960100
160,"Census Tract 24, Knox County, Tennessee",1833,35,1.91,1798,29.67,47093002400
161,"Census Tract 52.01, Knox County, Tennessee",2970,67,2.26,2903,30.95,47093005201
162,"Census Tract 33, Knox County, Tennessee",1117,58,5.19,1059,26.93,47093003300
163,"Census Tract 47, Knox County, Tennessee",2374,87,3.66,2287,27.9,47093004700
164,"Census Tract 51, Knox County, Tennessee",3336,300,8.99,3036,30.98,47093005100
165,"Census Tract 58.03, Knox County, Tennessee",1264,39,3.09,1225,24.11,47093005803
166,"Census Tract 61.02, Knox County, Tennessee",2624,102,3.89,2522,28.02,47093006102
167,"Census Tract 62.03, Knox County, Tennessee",2562,60,2.34,2502,27.51,47093006203
168,"Census Tract 16, Knox County, Tennessee",1275,54,4.24,1221,26.09,47093001600
169,"Census Tract 22, Knox County, Tennessee",1815,77,4.24,1738,27.47,47093002200
170,"Census Tract 408.10, Rutherford County, Tennessee",1223,60,4.91,1163,44.24,47149040810
171,"Census Tract 409.01, Rutherford County, Tennessee",1971,76,3.86,1895,33.91,47149040901
172,"Census Tract 409.02, Rutherford County, Tennessee",7732,528,6.83,7204,33.83,47149040902
173,"Census Tract 409.03, Rutherford County, Tennessee",7039,337,4.79,6702,34.34,47149040903
174,"Census Tract 409.04, Rutherford County, Tennessee",2416,72,2.98,2344,30.8,47149040904
175,"Census Tract 409.05, Rutherford County, Tennessee",5724,329,5.75,5395,42.68,47149040905
176,"Census Tract 411.01, Rutherford County, Tennessee",4144,149,3.6,3995,33.16,47149041101
177,"Census Tract 411.02, Rutherford County, Tennessee",1268,55,4.34,1213,34.48,47149041102
178,"Census Tract 412.01, Rutherford County, Tennessee",2793,143,5.12,2650,39.62,47149041201
179,"Census Tract 412.02, Rutherford County, Tennessee",2224,70,3.15,2154,35.21,47149041202
180,"Census Tract 413.01, Rutherford County, Tennessee",2674,204,7.63,2470,30.44,47149041301
181,"Census Tract 413.02, Rutherford County, Tennessee",3273,72,2.2,3201,32.24,47149041302
182,"Census Tract 414.01, Rutherford County, Tennessee",2593,131,5.05,2462,32.26,47149041401
183,"Census Tract 414.02, Rutherford County, Tennessee",3928,165,4.2,3763,34.06,47149041402
184,"Census Tract 414.03, Rutherford County, Tennessee",5651,225,3.98,5426,31.86,47149041403
185,"Census Tract 422, Rutherford County, Tennessee",2796,38,1.36,2758,31.01,47149042200
186,"Census Tract 601.01, Sequatchie County, Tennessee",3042,92,3.02,2950,38.83,47153060101
187,"Census Tract 601.02, Sequatchie County, Tennessee",793,36,4.54,757,42.34,47153060102
188,"Census Tract 801.01, Sevier County, Tennessee",1934,13,0.67,1921,29.46,47155080101
189,"Census Tract 93, Shelby County, Tennessee",2204,49,2.22,2155,22.94,47157009300
190,"Census Tract 106.10, Shelby County, Tennessee",2514,30,1.19,2484,24.08,47157010610
191,"Census Tract 202.22, Shelby County, Tennessee",1326,16,1.21,1310,35.88,47157020222
192,"Census Tract 211.38, Shelby County, Tennessee",1992,136,6.83,1856,29.27,47157021138
193,"Census Tract 213.41, Shelby County, Tennessee",2594,252,9.71,2342,24.81,47157021341
194,"Census Tract 213.51, Shelby County, Tennessee",2098,98,4.67,2000,25.02,47157021351
195,"Census Tract 213.52, Shelby County, Tennessee",3147,302,9.6,2845,27.05,47157021352
196,"Census Tract 215.20, Shelby County, Tennessee",7061,390,5.52,6671,28.61,47157021520
197,"Census Tract 217.21, Shelby County, Tennessee",2438,38,1.56,2400,23.45,47157021721
198,"Census Tract 217.32, Shelby County, Tennessee",3195,0,0.0,3195,24.01,47157021732
199,"Census Tract 217.51, Shelby County, Tennessee",3627,122,3.36,3505,31.59,47157021751
200,"Census Tract 222.20, Shelby County, Tennessee",1120,0,0.0,1120,29.14,47157022220
201,"Census Tract 100, Shelby County, Tennessee",2613,64,2.45,2549,25.74,47157010000
202,"Census Tract 81.10, Shelby County, Tennessee",822,31,3.77,791,32.27,47157008110
203,"Census Tract 81.20, Shelby County, Tennessee",1799,55,3.06,1744,24.49,47157008120
204,"Census Tract 202.10, Shelby County, Tennessee",2536,118,4.65,2418,28.33,47157020210
205,"Census Tract 205.41, Shelby County, Tennessee",2379,48,2.02,2331,29.57,47157020541
206,"Census Tract 101.10, Shelby County, Tennessee",2155,79,3.67,2076,25.49,47157010110
207,"Census Tract 106.30, Shelby County, Tennessee",1354,55,4.06,1299,26.36,47157010630
208,"Census Tract 204, Shelby County, Tennessee",648,18,2.78,630,12.56,47157020400
209,"Census Tract 205.42, Shelby County, Tennessee",2592,47,1.81,2545,25.03,47157020542
210,"Census Tract 206.22, Shelby County, Tennessee",1879,90,4.79,1789,28.22,47157020622
211,"Census Tract 211.13, Shelby County, Tennessee",2033,37,1.82,1996,24.14,47157021113
212,"Census Tract 213.42, Shelby County, Tennessee",5399,323,5.98,5076,24.88,47157021342
213,"Census Tract 215.30, Shelby County, Tennessee",2583,131,5.07,2452,29.84,47157021530
214,"Census Tract 216.11, Shelby County, Tennessee",3558,171,4.81,3387,29.11,47157021611
215,"Census Tract 217.31, Shelby County, Tennessee",1137,11,0.97,1126,24.44,47157021731
216,"Census Tract 9501, Polk County, Tennessee",412,11,2.67,401,38.93,47139950100
217,"Census Tract 415, Rutherford County, Tennessee",897,119,13.27,778,21.52,47149041500
218,"Census Tract 419, Rutherford County, Tennessee",1943,10,0.51,1933,29.52,47149041900
219,"Census Tract 418, Rutherford County, Tennessee",1453,41,2.82,1412,30.36,47149041800
220,"Census Tract 403.02, Rutherford County, Tennessee",5031,102,2.03,4929,38.04,47149040302
221,"Census Tract 404.03, Rutherford County, Tennessee",3737,124,3.32,3613,40.23,47149040403
222,"Census Tract 417, Rutherford County, Tennessee",2972,48,1.62,2924,26.26,47149041700
223,"Census Tract 410, Rutherford County, Tennessee",3954,218,5.51,3736,35.52,47149041000
224,"Census Tract 421, Rutherford County, Tennessee",5144,81,1.57,5063,27.98,47149042100
225,"Census Tract 420, Rutherford County, Tennessee",2772,332,11.98,2440,29.7,47149042000
226,"Census Tract 402, Rutherford County, Tennessee",2031,32,1.58,1999,35.82,47149040200
227,"Census Tract 416, Rutherford County, Tennessee",3076,59,1.92,3017,32.07,47149041600
228,"Census Tract 406, Rutherford County, Tennessee",2566,177,6.9,2389,38.68,47149040600
229,"Census Tract 1007, Hamblen County, Tennessee",2589,31,1.2,2558,30.62,47063100700
230,"Census Tract 1010, Hamblen County, Tennessee",2230,161,7.22,2069,26.05,47063101000
231,"Census Tract 1004, Hamblen County, Tennessee",2601,38,1.46,2563,28.08,47063100400
232,"Census Tract 1003, Hamblen County, Tennessee",1056,11,1.04,1045,23.17,47063100300
233,"Census Tract 1008, Hamblen County, Tennessee",1197,25,2.09,1172,24.84,47063100800
234,"Census Tract 1011, Hamblen County, Tennessee",1965,56,2.85,1909,25.22,47063101100
235,"Census Tract 1012, Hamblen County, Tennessee",3146,39,1.24,3107,28.51,47063101200
236,"Census Tract 1006, Hamblen County, Tennessee",2950,125,4.24,2825,24.47,47063100600
237,"Census Tract 1201, Houston County, Tennessee",1209,51,4.22,1158,39.83,47083120100
238,"Census Tract 1203, Houston County, Tennessee",886,14,1.58,872,47.76,47083120300
239,"Census Tract 1202, Houston County, Tennessee",761,20,2.63,741,40.01,47083120200
240,"Census Tract 112, Maury County, Tennessee",2661,84,3.16,2577,40.13,47119011200
241,"Census Tract 109, Maury County, Tennessee",1630,99,6.07,1531,41.6,47119010900
242,"Census Tract 101, Maury County, Tennessee",1511,72,4.77,1439,39.66,47119010100
243,"Census Tract 106, Maury County, Tennessee",2312,103,4.46,2209,31.64,47119010600
244,"Census Tract 105, Maury County, Tennessee",1633,2,0.12,1631,33.04,47119010500
245,"Census Tract 104, Maury County, Tennessee",2969,140,4.72,2829,39.15,47119010400
246,"Census Tract 107, Maury County, Tennessee",1795,60,3.34,1735,32.55,47119010700
247,"Census Tract 9501, Hickman County, Tennessee",2775,45,1.62,2730,49.31,47081950100
248,"Census Tract 9505, Hickman County, Tennessee",461,57,12.36,404,40.38,47081950500
249,"Census Tract 9502, Hickman County, Tennessee",2710,215,7.93,2495,45.12,47081950200
250,"Census Tract 1303, Humphreys County, Tennessee",2031,70,3.45,1961,32.36,47085130300
251,"Census Tract 1302, Humphreys County, Tennessee",706,0,0.0,706,30.94,47085130200
252,"Census Tract 1305, Humphreys County, Tennessee",1252,24,1.92,1228,33.31,47085130500
253,"Census Tract 1301, Humphreys County, Tennessee",2271,35,1.54,2236,40.68,47085130100
254,"Census Tract 1304, Humphreys County, Tennessee",780,36,4.62,744,36.42,47085130400
255,"Census Tract 705, Jefferson County, Tennessee",1968,94,4.78,1874,32.17,47089070500
256,"Census Tract 29, Knox County, Tennessee",1444,51,3.53,1393,23.31,47093002900
257,"Census Tract 45, Knox County, Tennessee",3468,196,5.65,3272,20.84,47093004500
258,"Census Tract 46.06, Knox County, Tennessee",3798,267,7.03,3531,25.15,47093004606
259,"Census Tract 52.02, Knox County, Tennessee",1723,33,1.92,1690,25.83,47093005202
260,"Census Tract 9751, Smith County, Tennessee",1317,4,0.3,1313,27.58,47159975100
261,"Census Tract 9754, Smith County, Tennessee",2378,65,2.73,2313,33.96,47159975400
262,"Census Tract 9752, Smith County, Tennessee",2221,92,4.14,2129,35.99,47159975200
263,"Census Tract 9753, Smith County, Tennessee",806,0,0.0,806,40.17,47159975300
264,"Census Tract 9750, Smith County, Tennessee",1903,115,6.04,1788,44.91,47159975000
265,"Census Tract 302.02, Wilson County, Tennessee",3763,248,6.59,3515,34.27,47189030202
266,"Census Tract 303.04, Wilson County, Tennessee",3403,311,9.14,3092,42.9,47189030304
267,"Census Tract 303.07, Wilson County, Tennessee",4729,315,6.66,4414,35.71,47189030307
268,"Census Tract 303.05, Wilson County, Tennessee",3149,86,2.73,3063,35.6,47189030305
269,"Census Tract 305, Wilson County, Tennessee",2984,64,2.14,2920,31.09,47189030500
270,"Census Tract 301.01, Wilson County, Tennessee",4800,146,3.04,4654,36.9,47189030101
271,"Census Tract 308, Wilson County, Tennessee",2913,256,8.79,2657,38.45,47189030800
272,"Census Tract 309.01, Wilson County, Tennessee",6017,358,5.95,5659,39.5,47189030901
273,"Census Tract 301.02, Wilson County, Tennessee",3414,172,5.04,3242,40.7,47189030102
274,"Census Tract 303.03, Wilson County, Tennessee",2306,120,5.2,2186,43.31,47189030303
275,"Census Tract 307, Wilson County, Tennessee",1207,55,4.56,1152,24.59,47189030700
276,"Census Tract 306, Wilson County, Tennessee",1679,85,5.06,1594,24.12,47189030600
277,"Census Tract 310, Wilson County, Tennessee",2634,114,4.33,2520,44.85,47189031000
278,"Census Tract 409, Sullivan County, Tennessee",1296,12,0.93,1284,22.32,47163040900
279,"Census Tract 413, Sullivan County, Tennessee",2157,108,5.01,2049,23.91,47163041300
280,"Census Tract 426, Sullivan County, Tennessee",1708,16,0.94,1692,23.31,47163042600
281,"Census Tract 430, Sullivan County, Tennessee",1902,44,2.31,1858,26.64,47163043000
282,"Census Tract 405, Sullivan County, Tennessee",1590,37,2.33,1553,20.25,47163040500
283,"Census Tract 56.02, Knox County, Tennessee",1873,171,9.13,1702,32.36,47093005602
284,"Census Tract 14, Knox County, Tennessee",621,8,1.29,613,29.23,47093001400
285,"Census Tract 21, Knox County, Tennessee",1269,22,1.73,1247,28.89,47093002100
286,"Census Tract 30, Knox County, Tennessee",2524,59,2.34,2465,22.45,47093003000
287,"Census Tract 41, Knox County, Tennessee",2220,43,1.94,2177,23.3,47093004100
288,"Census Tract 42, Knox County, Tennessee",1751,108,6.17,1643,25.0,47093004200
289,"Census Tract 48, Knox County, Tennessee",2759,211,7.65,2548,28.34,47093004800
290,"Census Tract 49, Knox County, Tennessee",2527,53,2.1,2474,23.86,47093004900
291,"Census Tract 20, Knox County, Tennessee",1345,9,0.67,1336,26.48,47093002000
292,"Census Tract 26, Knox County, Tennessee",1124,10,0.89,1114,21.18,47093002600
293,"Census Tract 28, Knox County, Tennessee",1962,0,0.0,1962,24.31,47093002800
294,"Census Tract 31, Knox County, Tennessee",1390,35,2.52,1355,27.51,47093003100
295,"Census Tract 62.02, Knox County, Tennessee",2576,82,3.18,2494,31.58,47093006202
296,"Census Tract 34, Knox County, Tennessee",2366,168,7.1,2198,24.06,47093003400
297,"Census Tract 50, Knox County, Tennessee",1926,84,4.36,1842,31.7,47093005000
298,"Census Tract 57.01, Knox County, Tennessee",2343,234,9.99,2109,24.95,47093005701
299,"Census Tract 8, Knox County, Tennessee",1963,0,0.0,1963,25.05,47093000800
300,"Census Tract 19, Knox County, Tennessee",600,14,2.33,586,25.7,47093001900
301,"Census Tract 23, Knox County, Tennessee",1914,99,5.17,1815,24.47,47093002300
302,"Census Tract 35, Knox County, Tennessee",2364,164,6.94,2200,21.16,47093003500
303,"Census Tract 32, Knox County, Tennessee",1226,29,2.37,1197,25.92,47093003200
304,"Census Tract 40, Knox County, Tennessee",2434,21,0.86,2413,28.28,47093004000
305,"Census Tract 57.04, Knox County, Tennessee",4103,254,6.19,3849,22.46,47093005704
306,"Census Tract 421, Sullivan County, Tennessee",2237,77,3.44,2160,27.43,47163042100
307,"Census Tract 428.01, Sullivan County, Tennessee",1311,28,2.14,1283,28.4,47163042801
308,"Census Tract 436, Sullivan County, Tennessee",2004,79,3.94,1925,24.29,47163043600
309,"Census Tract 429, Sullivan County, Tennessee",2017,76,3.77,1941,26.38,47163042900
310,"Census Tract 435, Sullivan County, Tennessee",1635,100,6.12,1535,27.33,47163043500
311,"Census Tract 414, Sullivan County, Tennessee",2171,95,4.38,2076,24.61,47163041400
312,"Census Tract 418, Sullivan County, Tennessee",1732,58,3.35,1674,25.15,47163041800
313,"Census Tract 427.01, Sullivan County, Tennessee",1910,28,1.47,1882,24.65,47163042701
314,"Census Tract 407, Sullivan County, Tennessee",1004,51,5.08,953,17.54,47163040700
315,"Census Tract 410, Sullivan County, Tennessee",1982,43,2.17,1939,24.11,47163041000
316,"Census Tract 415, Sullivan County, Tennessee",1064,60,5.64,1004,24.11,47163041500
317,"Census Tract 416, Sullivan County, Tennessee",969,49,5.06,920,24.4,47163041600
318,"Census Tract 417, Sullivan County, Tennessee",1152,20,1.74,1132,23.45,47163041700
319,"Census Tract 420, Sullivan County, Tennessee",1283,36,2.81,1247,24.43,47163042000
320,"Census Tract 403, Sullivan County, Tennessee",1208,0,0.0,1208,20.65,47163040300
321,"Census Tract 412, Sullivan County, Tennessee",2956,54,1.83,2902,24.5,47163041200
322,"Census Tract 423, Sullivan County, Tennessee",2776,95,3.42,2681,24.24,47163042300
323,"Census Tract 424, Sullivan County, Tennessee",1380,0,0.0,1380,25.68,47163042400
324,"Census Tract 427.02, Sullivan County, Tennessee",993,36,3.63,957,24.16,47163042702
325,"Census Tract 402, Sullivan County, Tennessee",767,25,3.26,742,24.17,47163040200
326,"Census Tract 408, Sullivan County, Tennessee",1214,55,4.53,1159,20.26,47163040800
327,"Census Tract 422, Sullivan County, Tennessee",1275,8,0.63,1267,27.68,47163042200
328,"Census Tract 425, Sullivan County, Tennessee",1557,31,1.99,1526,27.37,47163042500
329,"Census Tract 431, Sullivan County, Tennessee",1171,63,5.38,1108,30.96,47163043100
330,"Census Tract 411, Sullivan County, Tennessee",1070,69,6.45,1001,18.57,47163041100
331,"Census Tract 428.02, Sullivan County, Tennessee",1933,135,6.98,1798,27.1,47163042802
332,"Census Tract 707, Jefferson County, Tennessee",3363,140,4.16,3223,35.98,47089070700
333,"Census Tract 701, Jefferson County, Tennessee",3090,180,5.83,2910,30.87,47089070100
334,"Census Tract 702, Jefferson County, Tennessee",2154,52,2.41,2102,31.06,47089070200
335,"Census Tract 704, Jefferson County, Tennessee",1736,57,3.28,1679,32.09,47089070400
336,"Census Tract 706, Jefferson County, Tennessee",2348,159,6.77,2189,27.89,47089070600
337,"Census Tract 708, Jefferson County, Tennessee",3369,177,5.25,3192,33.04,47089070800
338,"Census Tract 709, Jefferson County, Tennessee",1773,71,4.0,1702,43.7,47089070900
339,"Census Tract 703, Jefferson County, Tennessee",2687,154,5.73,2533,26.02,47089070300
340,"Census Tract 13, Putnam County, Tennessee",1011,25,2.47,986,26.33,47141001300
341,"Census Tract 12, Putnam County, Tennessee",4786,171,3.57,4615,28.14,47141001200
342,"Census Tract 1, Putnam County, Tennessee",2011,58,2.88,1953,33.99,47141000100
343,"Census Tract 6, Putnam County, Tennessee",1662,80,4.81,1582,18.88,47141000600
344,"Census Tract 7, Putnam County, Tennessee",1609,26,1.62,1583,24.21,47141000700
345,"Census Tract 5, Putnam County, Tennessee",979,0,0.0,979,22.8,47141000500
346,"Census Tract 2, Putnam County, Tennessee",4652,244,5.25,4408,25.76,47141000200
347,"Census Tract 8, Putnam County, Tennessee",1642,9,0.55,1633,25.86,47141000800
348,"Census Tract 11, Putnam County, Tennessee",2818,123,4.36,2695,33.09,47141001100
349,"Census Tract 4, Putnam County, Tennessee",2241,115,5.13,2126,22.6,47141000400
350,"Census Tract 9, Putnam County, Tennessee",2649,42,1.59,2607,35.97,47141000900
351,"Census Tract 10, Putnam County, Tennessee",1538,44,2.86,1494,35.82,47141001000
352,"Census Tract 602, Sequatchie County, Tennessee",2013,55,2.73,1958,40.39,47153060200
353,"Census Tract 804, Sevier County, Tennessee",3409,103,3.02,3306,30.55,47155080400
354,"Census Tract 803, Sevier County, Tennessee",2634,172,6.53,2462,32.2,47155080300
355,"Census Tract 810, Sevier County, Tennessee",3316,109,3.29,3207,22.26,47155081000
356,"Census Tract 805, Sevier County, Tennessee",2459,130,5.29,2329,26.75,47155080500
357,"Census Tract 1102, Stewart County, Tennessee",2475,28,1.13,2447,37.64,47161110200
358,"Census Tract 1106, Stewart County, Tennessee",783,29,3.7,754,50.82,47161110600
359,"Census Tract 24, Shelby County, Tennessee",846,0,0.0,846,23.53,47157002400
360,"Census Tract 25, Shelby County, Tennessee",1492,49,3.28,1443,21.21,47157002500
361,"Census Tract 30, Shelby County, Tennessee",1191,28,2.35,1163,23.2,47157003000
362,"Census Tract 33, Shelby County, Tennessee",1418,143,10.08,1275,26.63,47157003300
363,"Census Tract 59, Shelby County, Tennessee",732,0,0.0,732,30.96,47157005900
364,"Census Tract 62, Shelby County, Tennessee",470,12,2.55,458,29.5,47157006200
365,"Census Tract 9632, Benton County, Tennessee",769,5,0.65,764,41.15,47005963200
366,"Census Tract 9633, Benton County, Tennessee",1239,0,0.0,1239,19.87,47005963300
367,"Census Tract 9634, Benton County, Tennessee",1303,12,0.92,1291,22.59,47005963400
368,"Census Tract 9530, Bledsoe County, Tennessee",1488,45,3.02,1443,45.13,47007953000
369,"Census Tract 9507, Campbell County, Tennessee",1598,95,5.94,1503,32.31,47013950700
370,"Census Tract 9531, Bledsoe County, Tennessee",2518,105,4.17,2413,35.37,47007953100
371,"Census Tract 9532, Bledsoe County, Tennessee",1597,71,4.45,1526,46.04,47007953200
372,"Census Tract 9503, Campbell County, Tennessee",630,38,6.03,592,38.01,47013950300
373,"Census Tract 9501, Campbell County, Tennessee",1017,12,1.18,1005,39.11,47013950100
374,"Census Tract 9502, Campbell County, Tennessee",637,4,0.63,633,22.44,47013950200
375,"Census Tract 9506, Campbell County, Tennessee",1381,0,0.0,1381,30.93,47013950600
376,"Census Tract 9505, Campbell County, Tennessee",2245,108,4.81,2137,27.71,47013950500
377,"Census Tract 9508, Campbell County, Tennessee",975,81,8.31,894,40.38,47013950800
378,"Census Tract 9509, Campbell County, Tennessee",935,9,0.96,926,41.59,47013950900
379,"Census Tract 9510, Campbell County, Tennessee",963,88,9.14,875,39.08,47013951000
380,"Census Tract 9511, Campbell County, Tennessee",2577,56,2.17,2521,36.59,47013951100
381,"Census Tract 9504, Campbell County, Tennessee",1991,29,1.46,1962,38.4,47013950400
382,"Census Tract 9601, Cannon County, Tennessee",1637,86,5.25,1551,43.78,47015960100
383,"Census Tract 9603, Cannon County, Tennessee",1895,126,6.65,1769,40.5,47015960300
384,"Census Tract 9602, Cannon County, Tennessee",2692,69,2.56,2623,35.35,47015960200
385,"Census Tract 9702, Coffee County, Tennessee",3255,68,2.09,3187,34.78,47031970200
386,"Census Tract 9704, Coffee County, Tennessee",2813,277,9.85,2536,29.66,47031970400
387,"Census Tract 9705, Coffee County, Tennessee",2528,111,4.39,2417,27.15,47031970500
388,"Census Tract 9706, Coffee County, Tennessee",1736,9,0.52,1727,30.38,47031970600
389,"Census Tract 9703, Coffee County, Tennessee",733,62,8.46,671,42.13,47031970300
390,"Census Tract 9709, Coffee County, Tennessee",1507,61,4.05,1446,25.76,47031970900
391,"Census Tract 9701, Coffee County, Tennessee",1694,79,4.66,1615,30.52,47031970100
392,"Census Tract 9707, Coffee County, Tennessee",2129,47,2.21,2082,27.25,47031970700
393,"Census Tract 9710, Coffee County, Tennessee",2516,53,2.11,2463,26.67,47031971000
394,"Census Tract 606, Fayette County, Tennessee",1673,18,1.08,1655,43.44,47047060600
395,"Census Tract 603, Fayette County, Tennessee",1143,48,4.2,1095,40.69,47047060300
396,"Census Tract 78.21, Shelby County, Tennessee",1514,82,5.42,1432,25.17,47157007821
397,"Census Tract 86, Shelby County, Tennessee",2964,178,6.01,2786,23.59,47157008600
398,"Census Tract 87, Shelby County, Tennessee",2315,97,4.19,2218,25.01,47157008700
399,"Census Tract 107.20, Shelby County, Tennessee",1909,17,0.89,1892,26.38,47157010720
400,"Census Tract 206.10, Shelby County, Tennessee",2087,15,0.72,2072,25.66,47157020610
401,"Census Tract 206.42, Shelby County, Tennessee",5278,102,1.93,5176,32.38,47157020642
402,"Census Tract 206.52, Shelby County, Tennessee",2424,136,5.61,2288,29.69,47157020652
403,"Census Tract 208.10, Shelby County, Tennessee",1450,65,4.48,1385,35.63,47157020810
404,"Census Tract 210.20, Shelby County, Tennessee",3237,106,3.27,3131,33.1,47157021020
405,"Census Tract 211.11, Shelby County, Tennessee",2058,15,0.73,2043,28.8,47157021111
406,"Census Tract 211.22, Shelby County, Tennessee",3057,138,4.51,2919,26.25,47157021122
407,"Census Tract 217.44, Shelby County, Tennessee",2949,105,3.56,2844,29.15,47157021744
408,"Census Tract 213.20, Shelby County, Tennessee",2872,82,2.86,2790,23.62,47157021320
409,"Census Tract 215.10, Shelby County, Tennessee",4773,132,2.77,4641,26.37,47157021510
410,"Census Tract 12, Shelby County, Tennessee",1904,24,1.26,1880,22.87,47157001200
411,"Census Tract 20, Shelby County, Tennessee",566,26,4.59,540,23.12,47157002000
412,"Census Tract 27, Shelby County, Tennessee",1153,66,5.72,1087,25.58,47157002700
413,"Census Tract 34, Shelby County, Tennessee",1341,76,5.67,1265,22.49,47157003400
414,"Census Tract 110.10, Shelby County, Tennessee",1378,0,0.0,1378,24.05,47157011010
415,"Census Tract 35, Shelby County, Tennessee",1868,89,4.76,1779,24.55,47157003500
416,"Census Tract 36, Shelby County, Tennessee",1045,7,0.67,1038,27.59,47157003600
417,"Census Tract 107.10, Shelby County, Tennessee",2151,34,1.58,2117,25.4,47157010710
418,"Census Tract 202.21, Shelby County, Tennessee",1356,53,3.91,1303,29.49,47157020221
419,"Census Tract 206.51, Shelby County, Tennessee",3458,173,5.0,3285,24.88,47157020651
420,"Census Tract 211.21, Shelby County, Tennessee",3093,13,0.42,3080,25.82,47157021121
421,"Census Tract 211.36, Shelby County, Tennessee",3061,210,6.86,2851,33.99,47157021136
422,"Census Tract 222.10, Shelby County, Tennessee",1291,48,3.72,1243,32.2,47157022210
423,"Census Tract 215.40, Shelby County, Tennessee",6037,222,3.68,5815,30.06,47157021540
424,"Census Tract 216.20, Shelby County, Tennessee",1401,38,2.71,1363,31.45,47157021620
425,"Census Tract 217.45, Shelby County, Tennessee",4796,187,3.9,4609,29.59,47157021745
426,"Census Tract 502, Hawkins County, Tennessee",1543,0,0.0,1543,42.08,47073050200
427,"Census Tract 504, Hawkins County, Tennessee",2302,68,2.95,2234,35.54,47073050400
428,"Census Tract 509, Hawkins County, Tennessee",1167,12,1.03,1155,29.39,47073050900
429,"Census Tract 508, Hawkins County, Tennessee",1512,52,3.44,1460,33.3,47073050800
430,"Census Tract 501, Hawkins County, Tennessee",1375,14,1.02,1361,32.67,47073050100
431,"Census Tract 507, Hawkins County, Tennessee",1463,26,1.78,1437,38.44,47073050700
432,"Census Tract 9563, Johnson County, Tennessee",1935,184,9.51,1751,21.73,47091956300
433,"Census Tract 9562, Johnson County, Tennessee",845,74,8.76,771,43.52,47091956200
434,"Census Tract 9560, Johnson County, Tennessee",339,17,5.01,322,55.37,47091956000
435,"Census Tract 9561, Johnson County, Tennessee",1073,55,5.13,1018,33.77,47091956100
436,"Census Tract 9564, Johnson County, Tennessee",1521,10,0.66,1511,28.61,47091956400
437,"Census Tract 9751, Lincoln County, Tennessee",1051,15,1.43,1036,35.52,47103975100
438,"Census Tract 9750, Lincoln County, Tennessee",721,29,4.02,692,38.03,47103975000
439,"Census Tract 9755, Lincoln County, Tennessee",1973,24,1.22,1949,39.12,47103975500
440,"Census Tract 9753, Lincoln County, Tennessee",2336,116,4.97,2220,30.25,47103975300
441,"Census Tract 9757, Lincoln County, Tennessee",1350,31,2.3,1319,41.45,47103975700
442,"Census Tract 9754, Lincoln County, Tennessee",1673,19,1.14,1654,25.24,47103975400
443,"Census Tract 9752, Lincoln County, Tennessee",881,13,1.48,868,36.89,47103975200
444,"Census Tract 9703, Macon County, Tennessee",3413,88,2.58,3325,40.85,47111970300
445,"Census Tract 9701, Macon County, Tennessee",1943,86,4.43,1857,42.71,47111970100
446,"Census Tract 9704, Macon County, Tennessee",1944,44,2.26,1900,40.86,47111970400
447,"Census Tract 9702, Macon County, Tennessee",2531,35,1.38,2496,36.21,47111970200
448,"Census Tract 2, Shelby County, Tennessee",249,0,0.0,249,28.3,47157000200
449,"Census Tract 3, Shelby County, Tennessee",299,0,0.0,299,34.28,47157000300
450,"Census Tract 37, Shelby County, Tennessee",425,6,1.41,419,23.02,47157003700
451,"Census Tract 9, Shelby County, Tennessee",732,0,0.0,732,28.64,47157000900
452,"Census Tract 16, Shelby County, Tennessee",1443,94,6.51,1349,20.21,47157001600
453,"Census Tract 29, Shelby County, Tennessee",2691,185,6.87,2506,23.33,47157002900
454,"Census Tract 38, Shelby County, Tennessee",332,20,6.02,312,21.64,47157003800
455,"Census Tract 45, Shelby County, Tennessee",302,0,0.0,302,26.4,47157004500
456,"Census Tract 50, Shelby County, Tennessee",190,0,0.0,190,25.78,47157005000
457,"Census Tract 69, Shelby County, Tennessee",949,49,5.16,900,24.96,47157006900
458,"Census Tract 82, Shelby County, Tennessee",1440,56,3.89,1384,27.74,47157008200
459,"Census Tract 98, Shelby County, Tennessee",1322,0,0.0,1322,24.02,47157009800
460,"Census Tract 85, Shelby County, Tennessee",1945,128,6.58,1817,23.11,47157008500
461,"Census Tract 88, Shelby County, Tennessee",2752,11,0.4,2741,28.42,47157008800
462,"Census Tract 94, Shelby County, Tennessee",1764,124,7.03,1640,22.01,47157009400
463,"Census Tract 220.22, Shelby County, Tennessee",1497,28,1.87,1469,25.29,47157022022
464,"Census Tract 104.13, Hamilton County, Tennessee",2011,201,10.0,1810,31.12,47065010413
465,"Census Tract 105.01, Hamilton County, Tennessee",3241,94,2.9,3147,23.54,47065010501
466,"Census Tract 105.02, Hamilton County, Tennessee",1554,90,5.79,1464,25.05,47065010502
467,"Census Tract 117, Hamilton County, Tennessee",2243,63,2.81,2180,20.51,47065011700
468,"Census Tract 104.32, Hamilton County, Tennessee",2766,180,6.51,2586,26.46,47065010432
469,"Census Tract 104.12, Hamilton County, Tennessee",2476,86,3.47,2390,29.91,47065010412
470,"Census Tract 114.42, Hamilton County, Tennessee",1540,133,8.64,1407,22.82,47065011442
471,"Census Tract 13, Hamilton County, Tennessee",741,55,7.42,686,20.62,47065001300
472,"Census Tract 101.01, Hamilton County, Tennessee",3010,111,3.69,2899,28.2,47065010101
473,"Census Tract 20, Hamilton County, Tennessee",848,59,6.96,789,20.32,47065002000
474,"Census Tract 9624, Carroll County, Tennessee",1148,41,3.57,1107,41.57,47017962400
475,"Census Tract 9620, Carroll County, Tennessee",1475,62,4.2,1413,26.55,47017962000
476,"Census Tract 9621, Carroll County, Tennessee",2227,27,1.21,2200,25.58,47017962100
477,"Census Tract 9623, Carroll County, Tennessee",1651,53,3.21,1598,34.35,47017962300
478,"Census Tract 9625, Carroll County, Tennessee",827,9,1.09,818,33.63,47017962500
479,"Census Tract 9702, Chester County, Tennessee",1955,123,6.29,1832,20.23,47023970200
480,"Census Tract 9703, Chester County, Tennessee",2225,28,1.26,2197,33.01,47023970300
481,"Census Tract 9701, Chester County, Tennessee",2669,89,3.33,2580,37.64,47023970100
482,"Census Tract 103.02, Davidson County, Tennessee",950,60,6.32,890,29.19,47037010302
483,"Census Tract 112, Davidson County, Tennessee",2325,319,13.72,2006,29.78,47037011200
484,"Census Tract 104.02, Davidson County, Tennessee",2677,121,4.52,2556,35.44,47037010402
485,"Census Tract 105.02, Davidson County, Tennessee",2484,127,5.11,2357,31.41,47037010502
486,"Census Tract 109.04, Davidson County, Tennessee",1315,12,0.91,1303,30.93,47037010904
487,"Census Tract 113, Davidson County, Tennessee",2674,106,3.96,2568,25.38,47037011300
488,"Census Tract 137, Davidson County, Tennessee",2133,84,3.94,2049,25.81,47037013700
489,"Census Tract 142, Davidson County, Tennessee",939,12,1.28,927,23.78,47037014200
490,"Census Tract 148, Davidson County, Tennessee",775,9,1.16,766,25.4,47037014800
491,"Census Tract 156.10, Davidson County, Tennessee",5516,307,5.57,5209,33.77,47037015610
492,"Census Tract 156.14, Davidson County, Tennessee",2470,51,2.06,2419,29.5,47037015614
493,"Census Tract 160, Davidson County, Tennessee",627,19,3.03,608,26.48,47037016000
494,"Census Tract 170, Davidson County, Tennessee",1860,158,8.49,1702,18.3,47037017000
495,"Census Tract 171, Davidson County, Tennessee",1869,135,7.22,1734,19.23,47037017100
496,"Census Tract 174.01, Davidson County, Tennessee",1358,59,4.34,1299,22.18,47037017401
497,"Census Tract 185, Davidson County, Tennessee",2464,143,5.8,2321,24.74,47037018500
498,"Census Tract 187, Davidson County, Tennessee",1461,213,14.58,1248,22.47,47037018700
499,"Census Tract 191.09, Davidson County, Tennessee",2815,15,0.53,2800,30.48,47037019109
500,"Census Tract 191.12, Davidson County, Tennessee",2491,50,2.01,2441,32.4,47037019112
501,"Census Tract 103.01, Davidson County, Tennessee",1765,21,1.19,1744,30.88,47037010301
502,"Census Tract 104.01, Davidson County, Tennessee",2498,77,3.08,2421,34.25,47037010401
503,"Census Tract 110.02, Davidson County, Tennessee",1470,99,6.73,1371,26.22,47037011002
504,"Census Tract 155.02, Davidson County, Tennessee",2162,218,10.08,1944,26.84,47037015502
505,"Census Tract 143, Davidson County, Tennessee",887,28,3.16,859,24.82,47037014300
506,"Census Tract 154.02, Davidson County, Tennessee",2665,85,3.19,2580,34.98,47037015402
507,"Census Tract 154.05, Davidson County, Tennessee",2511,132,5.26,2379,39.18,47037015405
508,"Census Tract 156.15, Davidson County, Tennessee",2288,63,2.75,2225,30.61,47037015615
509,"Census Tract 156.18, Davidson County, Tennessee",3599,101,2.81,3498,36.45,47037015618
510,"Census Tract 165, Davidson County, Tennessee",1910,208,10.89,1702,16.3,47037016500
511,"Census Tract 168, Davidson County, Tennessee",3017,162,5.37,2855,19.25,47037016800
512,"Census Tract 174.02, Davidson County, Tennessee",3072,105,3.42,2967,26.56,47037017402
513,"Census Tract 175, Davidson County, Tennessee",1462,24,1.64,1438,22.63,47037017500
514,"Census Tract 181.02, Davidson County, Tennessee",1840,166,9.02,1674,24.86,47037018102
515,"Census Tract 184.01, Davidson County, Tennessee",3705,222,5.99,3483,29.76,47037018401
516,"Census Tract 186.02, Davidson County, Tennessee",2107,135,6.41,1972,25.49,47037018602
517,"Census Tract 190.03, Davidson County, Tennessee",2161,127,5.88,2034,28.77,47037019003
518,"Census Tract 46.14, Knox County, Tennessee",1708,117,6.85,1591,24.37,47093004614
519,"Census Tract 46.15, Knox County, Tennessee",2001,29,1.45,1972,24.28,47093004615
520,"Census Tract 53.01, Knox County, Tennessee",2022,113,5.59,1909,30.43,47093005301
521,"Census Tract 53.02, Knox County, Tennessee",2016,214,10.62,1802,32.56,47093005302
522,"Census Tract 54.01, Knox County, Tennessee",1624,94,5.79,1530,28.42,47093005401
523,"Census Tract 213.11, Shelby County, Tennessee",2118,252,11.9,1866,24.35,47157021311
524,"Census Tract 213.12, Shelby County, Tennessee",1333,41,3.08,1292,19.98,47157021312
525,"Census Tract 213.33, Shelby County, Tennessee",2445,98,4.01,2347,24.77,47157021333
526,"Census Tract 213.34, Shelby County, Tennessee",2095,35,1.67,2060,23.52,47157021334
527,"Census Tract 217.25, Shelby County, Tennessee",2922,58,1.98,2864,25.2,47157021725
528,"Census Tract 217.26, Shelby County, Tennessee",1474,0,0.0,1474,23.84,47157021726
529,"Census Tract 217.46, Shelby County, Tennessee",2680,16,0.6,2664,28.89,47157021746
530,"Census Tract 217.47, Shelby County, Tennessee",1824,65,3.56,1759,26.13,47157021747
531,"Census Tract 220.23, Shelby County, Tennessee",639,0,0.0,639,28.02,47157022023
532,"Census Tract 220.24, Shelby County, Tennessee",1527,0,0.0,1527,24.89,47157022024
533,"Census Tract 221.21, Shelby County, Tennessee",1827,62,3.39,1765,25.69,47157022121
534,"Census Tract 221.22, Shelby County, Tennessee",1823,9,0.49,1814,23.62,47157022122
535,"Census Tract 225, Shelby County, Tennessee",1803,23,1.28,1780,25.74,47157022500
536,"Census Tract 226, Shelby County, Tennessee",1945,80,4.11,1865,23.12,47157022600
537,"Census Tract 227, Shelby County, Tennessee",2696,0,0.0,2696,29.08,47157022700
538,"Census Tract 9801, Shelby County, Tennessee",4,0,0.0,4,14.0,47157980100
539,"Census Tract 9802, Shelby County, Tennessee",0,0,,0,0.0,47157980200
540,"Census Tract 9803, Shelby County, Tennessee",0,0,,0,0.0,47157980300
541,"Census Tract 9804, Shelby County, Tennessee",0,0,,0,0.0,47157980400
542,"Census Tract 1107, Stewart County, Tennessee",1861,46,2.47,1815,36.23,47161110700
543,"Census Tract 9801, Stewart County, Tennessee",0,0,,0,0.0,47161980100
544,"Census Tract 9802, Stewart County, Tennessee",0,0,,0,0.0,47161980200
545,"Census Tract 432.01, Sullivan County, Tennessee",2013,109,5.41,1904,28.63,47163043201
546,"Census Tract 432.02, Sullivan County, Tennessee",1861,121,6.5,1740,30.55,47163043202
547,"Census Tract 433.01, Sullivan County, Tennessee",2718,176,6.48,2542,29.08,47163043301
548,"Census Tract 433.02, Sullivan County, Tennessee",2267,117,5.16,2150,27.32,47163043302
549,"Census Tract 201.02, Sumner County, Tennessee",2185,86,3.94,2099,41.72,47165020102
550,"Census Tract 434.01, Sullivan County, Tennessee",2451,114,4.65,2337,27.11,47163043401
551,"Census Tract 434.02, Sullivan County, Tennessee",1726,43,2.49,1683,24.89,47163043402
552,"Census Tract 201.01, Sumner County, Tennessee",1717,37,2.15,1680,37.69,47165020101
553,"Census Tract 202.03, Sumner County, Tennessee",1259,52,4.13,1207,38.75,47165020203
554,"Census Tract 202.04, Sumner County, Tennessee",1639,93,5.67,1546,37.18,47165020204
555,"Census Tract 202.05, Sumner County, Tennessee",1702,18,1.06,1684,39.21,47165020205
556,"Census Tract 202.06, Sumner County, Tennessee",589,32,5.43,557,29.57,47165020206
557,"Census Tract 202.07, Sumner County, Tennessee",750,52,6.93,698,35.48,47165020207
558,"Census Tract 202.08, Sumner County, Tennessee",1272,48,3.77,1224,37.63,47165020208
559,"Census Tract 202.09, Sumner County, Tennessee",937,18,1.92,919,43.94,47165020209
560,"Census Tract 54.02, Knox County, Tennessee",1337,107,8.0,1230,29.46,47093005402
561,"Census Tract 55.01, Knox County, Tennessee",1298,57,4.39,1241,30.14,47093005501
562,"Census Tract 55.02, Knox County, Tennessee",1548,59,3.81,1489,27.35,47093005502
563,"Census Tract 126, Davidson County, Tennessee",1112,69,6.21,1043,32.03,47037012600
564,"Census Tract 105.01, Davidson County, Tennessee",3056,160,5.24,2896,39.31,47037010501
565,"Census Tract 114, Davidson County, Tennessee",2793,164,5.87,2629,28.8,47037011400
566,"Census Tract 138, Davidson County, Tennessee",934,13,1.39,921,30.47,47037013800
567,"Census Tract 154.01, Davidson County, Tennessee",3028,143,4.72,2885,35.21,47037015401
568,"Census Tract 156.12, Davidson County, Tennessee",4756,134,2.82,4622,33.0,47037015612
569,"Census Tract 157, Davidson County, Tennessee",850,34,4.0,816,26.7,47037015700
570,"Census Tract 163, Davidson County, Tennessee",1080,72,6.67,1008,19.82,47037016300
571,"Census Tract 180, Davidson County, Tennessee",3062,366,11.95,2696,20.62,47037018000
572,"Census Tract 181.01, Davidson County, Tennessee",2923,76,2.6,2847,26.1,47037018101
573,"Census Tract 184.04, Davidson County, Tennessee",3330,375,11.26,2955,28.21,47037018404
574,"Census Tract 188.01, Davidson County, Tennessee",3354,406,12.1,2948,31.02,47037018801
575,"Census Tract 191.05, Davidson County, Tennessee",3174,86,2.71,3088,33.05,47037019105
576,"Census Tract 191.06, Davidson County, Tennessee",2676,180,6.73,2496,28.94,47037019106
577,"Census Tract 191.14, Davidson County, Tennessee",7910,967,12.23,6943,36.13,47037019114
578,"Census Tract 419, Sullivan County, Tennessee",1249,73,5.84,1176,22.39,47163041900
579,"Census Tract 406, Sullivan County, Tennessee",995,20,2.01,975,25.3,47163040600
580,"Census Tract 802, Unicoi County, Tennessee",2138,102,4.77,2036,20.37,47171080200
581,"Census Tract 804, Unicoi County, Tennessee",1267,21,1.66,1246,22.35,47171080400
582,"Census Tract 803, Unicoi County, Tennessee",2517,147,5.84,2370,31.47,47171080300
583,"Census Tract 801, Unicoi County, Tennessee",874,62,7.09,812,29.19,47171080100
584,"Census Tract 212.03, Sumner County, Tennessee",3694,326,8.83,3368,36.81,47165021203
585,"Census Tract 9502, Wayne County, Tennessee",2092,22,1.05,2070,25.63,47181950200
586,"Census Tract 9504, Wayne County, Tennessee",961,20,2.08,941,46.13,47181950400
587,"Census Tract 9503, Wayne County, Tennessee",1404,36,2.56,1368,37.5,47181950300
588,"Census Tract 9501, Wayne County, Tennessee",1224,38,3.1,1186,42.6,47181950100
589,"Census Tract 902, Trousdale County, Tennessee",1307,101,7.73,1206,33.47,47169090200
590,"Census Tract 901, Trousdale County, Tennessee",2688,92,3.42,2596,41.38,47169090100
591,"Census Tract 508, Williamson County, Tennessee",2847,103,3.62,2744,29.03,47187050800
592,"Census Tract 505.02, Williamson County, Tennessee",1924,114,5.93,1810,38.31,47187050502
593,"Census Tract 9501, Bedford County, Tennessee",2040,198,9.71,1842,35.24,47003950100
594,"Census Tract 9502, Bedford County, Tennessee",3306,80,2.42,3226,35.02,47003950200
595,"Census Tract 9503, Bedford County, Tennessee",1582,51,3.22,1531,34.63,47003950300
596,"Census Tract 9507, Bedford County, Tennessee",1364,42,3.08,1322,31.84,47003950700
597,"Census Tract 9508, Bedford County, Tennessee",1665,38,2.28,1627,29.73,47003950800
598,"Census Tract 101.20, Shelby County, Tennessee",1880,22,1.17,1858,27.3,47157010120
599,"Census Tract 102.20, Shelby County, Tennessee",2722,0,0.0,2722,27.17,47157010220
600,"Census Tract 211.12, Shelby County, Tennessee",3594,98,2.73,3496,27.2,47157021112
601,"Census Tract 205.21, Shelby County, Tennessee",1229,53,4.31,1176,27.82,47157020521
602,"Census Tract 206.32, Shelby County, Tennessee",2751,81,2.94,2670,29.05,47157020632
603,"Census Tract 213.31, Shelby County, Tennessee",1617,108,6.68,1509,25.59,47157021331
604,"Census Tract 214.30, Shelby County, Tennessee",2190,134,6.12,2056,23.39,47157021430
605,"Census Tract 216.12, Shelby County, Tennessee",2598,134,5.16,2464,30.74,47157021612
606,"Census Tract 216.13, Shelby County, Tennessee",2366,193,8.16,2173,32.65,47157021613
607,"Census Tract 56.03, Knox County, Tennessee",1990,77,3.87,1913,30.01,47093005603
608,"Census Tract 56.04, Knox County, Tennessee",1119,49,4.38,1070,25.45,47093005604
609,"Census Tract 57.06, Knox County, Tennessee",2008,180,8.96,1828,24.0,47093005706
610,"Census Tract 57.07, Knox County, Tennessee",1698,135,7.95,1563,25.17,47093005707
611,"Census Tract 57.08, Knox County, Tennessee",1692,81,4.79,1611,24.88,47093005708
612,"Census Tract 57.09, Knox County, Tennessee",1111,36,3.24,1075,27.58,47093005709
613,"Census Tract 57.10, Knox County, Tennessee",1166,116,9.95,1050,28.98,47093005710
614,"Census Tract 57.11, Knox County, Tennessee",3008,187,6.22,2821,27.33,47093005711
615,"Census Tract 57.12, Knox County, Tennessee",4388,391,8.91,3997,26.57,47093005712
616,"Census Tract 58.07, Knox County, Tennessee",1429,74,5.18,1355,23.89,47093005807
617,"Census Tract 58.08, Knox County, Tennessee",2791,99,3.55,2692,24.07,47093005808
618,"Census Tract 58.09, Knox County, Tennessee",2495,172,6.89,2323,24.98,47093005809
619,"Census Tract 58.10, Knox County, Tennessee",1626,150,9.23,1476,27.45,47093005810
620,"Census Tract 58.11, Knox County, Tennessee",1429,82,5.74,1347,29.58,47093005811
621,"Census Tract 58.12, Knox County, Tennessee",3157,271,8.58,2886,30.84,47093005812
622,"Census Tract 58.13, Knox County, Tennessee",2595,241,9.29,2354,25.29,47093005813
623,"Census Tract 59.03, Knox County, Tennessee",2235,135,6.04,2100,23.77,47093005903
624,"Census Tract 59.04, Knox County, Tennessee",3117,196,6.29,2921,25.37,47093005904
625,"Census Tract 59.05, Knox County, Tennessee",1368,125,9.14,1243,23.66,47093005905
626,"Census Tract 59.06, Knox County, Tennessee",1044,57,5.46,987,30.09,47093005906
627,"Census Tract 59.07, Knox County, Tennessee",1971,113,5.73,1858,25.3,47093005907
628,"Census Tract 59.08, Knox County, Tennessee",2522,202,8.01,2320,25.68,47093005908
629,"Census Tract 60.01, Knox County, Tennessee",2034,42,2.06,1992,24.69,47093006001
630,"Census Tract 60.02, Knox County, Tennessee",3066,264,8.61,2802,27.78,47093006002
631,"Census Tract 60.03, Knox County, Tennessee",2114,143,6.76,1971,29.91,47093006003
632,"Census Tract 61.03, Knox County, Tennessee",2400,124,5.17,2276,31.05,47093006103
633,"Census Tract 61.04, Knox County, Tennessee",2568,144,5.61,2424,30.9,47093006104
634,"Census Tract 62.05, Knox County, Tennessee",2063,182,8.82,1881,29.94,47093006205
635,"Census Tract 62.06, Knox County, Tennessee",2456,115,4.68,2341,28.84,47093006206
636,"Census Tract 62.07, Knox County, Tennessee",1711,44,2.57,1667,26.95,47093006207
637,"Census Tract 62.08, Knox County, Tennessee",2368,34,1.44,2334,33.54,47093006208
638,"Census Tract 63.01, Knox County, Tennessee",1632,62,3.8,1570,30.72,47093006301
639,"Census Tract 204.04, Sumner County, Tennessee",936,40,4.27,896,37.05,47165020404
640,"Census Tract 63.02, Knox County, Tennessee",1351,92,6.81,1259,38.18,47093006302
641,"Census Tract 64.01, Knox County, Tennessee",2088,6,0.29,2082,35.51,47093006401
642,"Census Tract 204.03, Sumner County, Tennessee",1028,51,4.96,977,36.1,47165020403
643,"Census Tract 204.05, Sumner County, Tennessee",1038,38,3.66,1000,41.52,47165020405
644,"Census Tract 204.06, Sumner County, Tennessee",1694,123,7.26,1571,46.16,47165020406
645,"Census Tract 204.07, Sumner County, Tennessee",2531,20,0.79,2511,37.09,47165020407
646,"Census Tract 205.01, Sumner County, Tennessee",2643,300,11.35,2343,39.08,47165020501
647,"Census Tract 205.02, Sumner County, Tennessee",2770,215,7.76,2555,36.14,47165020502
648,"Census Tract 205.03, Sumner County, Tennessee",1085,31,2.86,1054,36.31,47165020503
649,"Census Tract 206.01, Sumner County, Tennessee",1829,183,10.01,1646,33.49,47165020601
650,"Census Tract 206.02, Sumner County, Tennessee",2333,83,3.56,2250,35.6,47165020602
651,"Census Tract 158.02, Davidson County, Tennessee",3637,220,6.05,3417,31.67,47037015802
652,"Census Tract 217.41, Shelby County, Tennessee",3439,145,4.22,3294,25.67,47157021741
653,"Census Tract 219, Shelby County, Tennessee",2222,23,1.04,2199,26.93,47157021900
654,"Census Tract 221.11, Shelby County, Tennessee",1850,24,1.3,1826,23.35,47157022111
655,"Census Tract 221.30, Shelby County, Tennessee",2253,0,0.0,2253,30.35,47157022130
656,"Census Tract 4, Madison County, Tennessee",1553,10,0.64,1543,23.84,47113000400
657,"Census Tract 6, Madison County, Tennessee",924,30,3.25,894,24.65,47113000600
658,"Census Tract 13, Madison County, Tennessee",2463,111,4.51,2352,24.77,47113001300
659,"Census Tract 16.04, Madison County, Tennessee",1559,0,0.0,1559,18.74,47113001604
660,"Census Tract 16.07, Madison County, Tennessee",2865,105,3.66,2760,24.06,47113001607
661,"Census Tract 18, Madison County, Tennessee",1541,16,1.04,1525,27.96,47113001800
662,"Census Tract 16.10, Madison County, Tennessee",2956,131,4.43,2825,24.9,47113001610
663,"Census Tract 3, Madison County, Tennessee",1757,76,4.33,1681,18.35,47113000300
664,"Census Tract 9501, Overton County, Tennessee",641,53,8.27,588,46.3,47133950100
665,"Census Tract 9502, Overton County, Tennessee",734,38,5.18,696,41.99,47133950200
666,"Census Tract 9504, Overton County, Tennessee",854,30,3.51,824,34.87,47133950400
667,"Census Tract 9505, Overton County, Tennessee",2838,22,0.78,2816,31.6,47133950500
668,"Census Tract 9506, Overton County, Tennessee",930,0,0.0,930,34.4,47133950600
669,"Census Tract 209.02, Sumner County, Tennessee",3302,82,2.48,3220,32.14,47165020902
670,"Census Tract 208, Sumner County, Tennessee",2792,124,4.44,2668,26.52,47165020800
671,"Census Tract 211.03, Sumner County, Tennessee",3379,199,5.89,3180,37.34,47165021103
672,"Census Tract 207, Sumner County, Tennessee",1614,138,8.55,1476,30.33,47165020700
673,"Census Tract 203, Sumner County, Tennessee",2274,69,3.03,2205,27.35,47165020300
674,"Census Tract 209.01, Sumner County, Tennessee",791,117,14.79,674,42.44,47165020901
675,"Census Tract 210.02, Sumner County, Tennessee",3598,231,6.42,3367,32.79,47165021002
676,"Census Tract 212.01, Sumner County, Tennessee",3719,315,8.47,3404,32.54,47165021201
677,"Census Tract 223.21, Shelby County, Tennessee",1364,0,0.0,1364,27.58,47157022321
678,"Census Tract 203, Shelby County, Tennessee",2186,84,3.84,2102,32.42,47157020300
679,"Census Tract 210.10, Shelby County, Tennessee",9660,194,2.01,9466,36.29,47157021010
680,"Census Tract 206.21, Shelby County, Tennessee",4085,18,0.44,4067,23.27,47157020621
681,"Census Tract 214.20, Shelby County, Tennessee",1468,35,2.38,1433,24.31,47157021420
682,"Census Tract 221.12, Shelby County, Tennessee",2930,32,1.09,2898,29.01,47157022112
683,"Census Tract 4, Shelby County, Tennessee",423,4,0.95,419,40.06,47157000400
684,"Census Tract 128.02, Davidson County, Tennessee",1477,55,3.72,1422,27.05,47037012802
685,"Census Tract 26, Shelby County, Tennessee",1645,71,4.32,1574,19.42,47157002600
686,"Census Tract 213.53, Shelby County, Tennessee",4149,207,4.99,3942,28.3,47157021353
687,"Census Tract 152, Davidson County, Tennessee",1450,39,2.69,1411,27.08,47037015200
688,"Census Tract 131, Davidson County, Tennessee",1091,59,5.41,1032,31.58,47037013100
689,"Census Tract 134, Davidson County, Tennessee",3197,225,7.04,2972,22.43,47037013400
690,"Census Tract 173, Davidson County, Tennessee",2104,67,3.18,2037,23.92,47037017300
691,"Census Tract 179.01, Davidson County, Tennessee",2199,351,15.96,1848,22.94,47037017901
692,"Census Tract 118, Davidson County, Tennessee",1149,117,10.18,1032,22.31,47037011800
693,"Census Tract 109.01, Davidson County, Tennessee",1659,59,3.56,1600,32.14,47037010901
694,"Census Tract 122, Davidson County, Tennessee",1310,192,14.66,1118,29.85,47037012200
695,"Census Tract 154.04, Davidson County, Tennessee",1356,25,1.84,1331,35.8,47037015404
696,"Census Tract 130, Davidson County, Tennessee",0,0,,0,0.0,47037013000
697,"Census Tract 166, Davidson County, Tennessee",2119,181,8.54,1938,22.86,47037016600
698,"Census Tract 167, Davidson County, Tennessee",3027,253,8.36,2774,21.75,47037016700
699,"Census Tract 169, Davidson County, Tennessee",3385,377,11.14,3008,20.12,47037016900
700,"Census Tract 179.02, Davidson County, Tennessee",2541,226,8.89,2315,24.32,47037017902
701,"Census Tract 107.02, Davidson County, Tennessee",1430,47,3.29,1383,31.84,47037010702
702,"Census Tract 108.02, Davidson County, Tennessee",1855,113,6.09,1742,29.9,47037010802
703,"Census Tract 110.01, Davidson County, Tennessee",2823,225,7.97,2598,30.38,47037011001
704,"Census Tract 115, Davidson County, Tennessee",2271,236,10.39,2035,31.17,47037011500
705,"Census Tract 127.01, Davidson County, Tennessee",2257,14,0.62,2243,24.71,47037012701
706,"Census Tract 128.01, Davidson County, Tennessee",2239,31,1.38,2208,31.89,47037012801
707,"Census Tract 119, Davidson County, Tennessee",1319,53,4.02,1266,23.34,47037011900
708,"Census Tract 116, Davidson County, Tennessee",3120,255,8.17,2865,27.52,47037011600
709,"Census Tract 121, Davidson County, Tennessee",1600,115,7.19,1485,27.96,47037012100
710,"Census Tract 127.02, Davidson County, Tennessee",1167,14,1.2,1153,23.54,47037012702
711,"Census Tract 115, Bradley County, Tennessee",4493,354,7.88,4139,27.27,47011011500
712,"Census Tract 112.01, Bradley County, Tennessee",3007,167,5.55,2840,29.42,47011011201
713,"Census Tract 101, Bradley County, Tennessee",2257,175,7.75,2082,20.31,47011010100
714,"Census Tract 105, Bradley County, Tennessee",1732,67,3.87,1665,18.0,47011010500
715,"Census Tract 108, Bradley County, Tennessee",1150,43,3.74,1107,21.55,47011010800
716,"Census Tract 102, Bradley County, Tennessee",2722,61,2.24,2661,22.28,47011010200
717,"Census Tract 103, Bradley County, Tennessee",1024,26,2.54,998,26.98,47011010300
718,"Census Tract 112.02, Bradley County, Tennessee",4297,250,5.82,4047,25.64,47011011202
719,"Census Tract 104, Bradley County, Tennessee",1148,11,0.96,1137,18.12,47011010400
720,"Census Tract 107, Bradley County, Tennessee",1757,56,3.19,1701,21.3,47011010700
721,"Census Tract 113, Bradley County, Tennessee",3451,148,4.29,3303,33.76,47011011300
722,"Census Tract 109, Bradley County, Tennessee",1160,11,0.95,1149,26.35,47011010900
723,"Census Tract 110, Bradley County, Tennessee",2659,101,3.8,2558,24.05,47011011000
724,"Census Tract 111, Bradley County, Tennessee",5151,158,3.07,4993,26.05,47011011100
725,"Census Tract 106, Bradley County, Tennessee",1493,62,4.15,1431,20.89,47011010600
726,"Census Tract 9601, Meigs County, Tennessee",1044,26,2.49,1018,39.86,47121960100
727,"Census Tract 9602, Meigs County, Tennessee",1773,37,2.09,1736,34.88,47121960200
728,"Census Tract 1001, Hamblen County, Tennessee",2888,160,5.54,2728,29.27,47063100100
729,"Census Tract 9603, Meigs County, Tennessee",1551,33,2.13,1518,38.38,47121960300
730,"Census Tract 1005, Hamblen County, Tennessee",1131,34,3.01,1097,26.63,47063100500
731,"Census Tract 1009, Hamblen County, Tennessee",2189,50,2.28,2139,27.23,47063100900
732,"Census Tract 1002, Hamblen County, Tennessee",1946,17,0.87,1929,21.18,47063100200
733,"Census Tract 202.01, Anderson County, Tennessee",1947,135,6.93,1812,25.32,47001020201
734,"Census Tract 202.02, Anderson County, Tennessee",1789,80,4.47,1709,27.03,47001020202
735,"Census Tract 9801, Anderson County, Tennessee",0,0,,0,0.0,47001980100
736,"Census Tract 9504.01, Bedford County, Tennessee",2644,80,3.03,2564,30.03,47003950401
737,"Census Tract 9504.02, Bedford County, Tennessee",2452,63,2.57,2389,28.06,47003950402
738,"Census Tract 103.01, Blount County, Tennessee",3465,13,0.38,3452,26.33,47009010301
739,"Census Tract 103.02, Blount County, Tennessee",1721,46,2.67,1675,26.52,47009010302
740,"Census Tract 110.01, Blount County, Tennessee",2613,119,4.55,2494,27.88,47009011001
741,"Census Tract 156.17, Davidson County, Tennessee",1407,66,4.69,1341,37.65,47037015617
742,"Census Tract 156.19, Davidson County, Tennessee",2749,61,2.22,2688,37.23,47037015619
743,"Census Tract 9802, Hamilton County, Tennessee",0,0,,0,0.0,47065980200
744,"Census Tract 9605, Hancock County, Tennessee",825,65,7.88,760,51.47,47067960500
745,"Census Tract 9606, Hancock County, Tennessee",1365,28,2.05,1337,33.15,47067960600
746,"Census Tract 9201, Hardin County, Tennessee",1617,136,8.41,1481,28.36,47071920100
747,"Census Tract 9202, Hardin County, Tennessee",1542,142,9.21,1400,37.03,47071920200
748,"Census Tract 9203, Hardin County, Tennessee",1536,76,4.95,1460,23.37,47071920300
749,"Census Tract 9204, Hardin County, Tennessee",1660,170,10.24,1490,20.4,47071920400
750,"Census Tract 808.01, Sevier County, Tennessee",1128,62,5.5,1066,26.82,47155080801
751,"Census Tract 808.02, Sevier County, Tennessee",3510,201,5.73,3309,23.73,47155080802
752,"Census Tract 809.01, Sevier County, Tennessee",1852,153,8.26,1699,24.52,47155080901
753,"Census Tract 809.02, Sevier County, Tennessee",2237,114,5.1,2123,34.17,47155080902
754,"Census Tract 811.01, Sevier County, Tennessee",946,38,4.02,908,20.23,47155081101
755,"Census Tract 811.02, Sevier County, Tennessee",1352,42,3.11,1310,20.53,47155081102
756,"Census Tract 9801, Sevier County, Tennessee",0,0,,0,0.0,47155980100
757,"Census Tract 99.01, Shelby County, Tennessee",1100,23,2.09,1077,29.56,47157009901
758,"Census Tract 99.02, Shelby County, Tennessee",888,62,6.98,826,26.3,47157009902
759,"Census Tract 111, Shelby County, Tennessee",430,2,0.47,428,24.73,47157011100
760,"Census Tract 112, Shelby County, Tennessee",416,16,3.85,400,38.45,47157011200
761,"Census Tract 113, Shelby County, Tennessee",511,42,8.22,469,25.28,47157011300
762,"Census Tract 114, Shelby County, Tennessee",890,0,0.0,890,32.64,47157011400
763,"Census Tract 115, Shelby County, Tennessee",737,0,0.0,737,25.19,47157011500
764,"Census Tract 116, Shelby County, Tennessee",594,14,2.36,580,24.78,47157011600
765,"Census Tract 117, Shelby County, Tennessee",346,14,4.05,332,23.69,47157011700
766,"Census Tract 118, Shelby County, Tennessee",2703,75,2.77,2628,25.35,47157011800
767,"Census Tract 201.01, Shelby County, Tennessee",1189,31,2.61,1158,31.23,47157020101
768,"Census Tract 201.02, Shelby County, Tennessee",1430,112,7.83,1318,36.94,47157020102
769,"Census Tract 205.23, Shelby County, Tennessee",1173,0,0.0,1173,31.91,47157020523
770,"Census Tract 205.24, Shelby County, Tennessee",2162,46,2.13,2116,27.31,47157020524
771,"Census Tract 205.31, Shelby County, Tennessee",2507,25,1.0,2482,27.63,47157020531
772,"Census Tract 205.32, Shelby County, Tennessee",3171,51,1.61,3120,27.69,47157020532
773,"Census Tract 206.43, Shelby County, Tennessee",4277,145,3.39,4132,28.62,47157020643
774,"Census Tract 206.33, Shelby County, Tennessee",1356,50,3.69,1306,27.86,47157020633
775,"Census Tract 206.34, Shelby County, Tennessee",1560,72,4.62,1488,25.53,47157020634
776,"Census Tract 206.35, Shelby County, Tennessee",1201,47,3.91,1154,27.52,47157020635
777,"Census Tract 206.44, Shelby County, Tennessee",5165,166,3.21,4999,31.24,47157020644
778,"Census Tract 208.31, Shelby County, Tennessee",1926,50,2.6,1876,30.05,47157020831
779,"Census Tract 208.32, Shelby County, Tennessee",4190,201,4.8,3989,29.95,47157020832
780,"Census Tract 211.24, Shelby County, Tennessee",4079,52,1.27,4027,25.89,47157021124
781,"Census Tract 211.25, Shelby County, Tennessee",2379,69,2.9,2310,24.59,47157021125
782,"Census Tract 211.26, Shelby County, Tennessee",2732,71,2.6,2661,26.15,47157021126
783,"Census Tract 211.39, Shelby County, Tennessee",2153,127,5.9,2026,30.71,47157021139
784,"Census Tract 211.40, Shelby County, Tennessee",2920,143,4.9,2777,26.77,47157021140
785,"Census Tract 211.41, Shelby County, Tennessee",3967,318,8.02,3649,33.01,47157021141
786,"Census Tract 110.02, Blount County, Tennessee",2097,86,4.1,2011,33.16,47009011002
787,"Census Tract 113.01, Blount County, Tennessee",3129,173,5.53,2956,38.99,47009011301
788,"Census Tract 113.02, Blount County, Tennessee",2840,104,3.66,2736,35.03,47009011302
789,"Census Tract 114.01, Blount County, Tennessee",587,54,9.2,533,34.61,47009011401
790,"Census Tract 114.02, Blount County, Tennessee",1756,179,10.19,1577,37.02,47009011402
791,"Census Tract 115.01, Blount County, Tennessee",717,32,4.46,685,41.85,47009011501
792,"Census Tract 115.02, Blount County, Tennessee",1853,42,2.27,1811,34.14,47009011502
793,"Census Tract 115.03, Blount County, Tennessee",3323,109,3.28,3214,32.21,47009011503
794,"Census Tract 116.03, Blount County, Tennessee",2252,110,4.88,2142,31.15,47009011603
795,"Census Tract 116.04, Blount County, Tennessee",1874,136,7.26,1738,25.66,47009011604
796,"Census Tract 116.05, Blount County, Tennessee",1627,145,8.91,1482,34.41,47009011605
797,"Census Tract 9801, Blount County, Tennessee",2,0,0.0,2,24.0,47009980100
798,"Census Tract 9802, Blount County, Tennessee",0,0,,0,0.0,47009980200
799,"Census Tract 114.01, Bradley County, Tennessee",3891,147,3.78,3744,22.67,47011011401
800,"Census Tract 604, Washington County, Tennessee",3084,150,4.86,2934,22.52,47179060400
801,"Census Tract 609, Washington County, Tennessee",2233,33,1.48,2200,19.74,47179060900
802,"Census Tract 618, Washington County, Tennessee",2871,56,1.95,2815,31.06,47179061800
803,"Census Tract 615, Washington County, Tennessee",3430,139,4.05,3291,23.82,47179061500
804,"Census Tract 606, Washington County, Tennessee",3289,178,5.41,3111,22.83,47179060600
805,"Census Tract 610, Washington County, Tennessee",1041,41,3.94,1000,17.73,47179061000
806,"Census Tract 601, Washington County, Tennessee",1413,50,3.54,1363,20.66,47179060100
807,"Census Tract 607, Washington County, Tennessee",510,0,0.0,510,20.42,47179060700
808,"Census Tract 613, Washington County, Tennessee",4256,77,1.81,4179,21.45,47179061300
809,"Census Tract 608, Washington County, Tennessee",1438,22,1.53,1416,20.67,47179060800
810,"Census Tract 612, Washington County, Tennessee",1633,43,2.63,1590,19.99,47179061200
811,"Census Tract 611, Washington County, Tennessee",1838,94,5.11,1744,19.84,47179061100
812,"Census Tract 9684, Weakley County, Tennessee",2106,12,0.57,2094,24.84,47183968400
813,"Census Tract 9683, Weakley County, Tennessee",905,18,1.99,887,29.34,47183968300
814,"Census Tract 9687, Weakley County, Tennessee",607,25,4.12,582,29.04,47183968700
815,"Census Tract 9680, Weakley County, Tennessee",442,6,1.36,436,43.63,47183968000
816,"Census Tract 9685, Weakley County, Tennessee",1802,3,0.17,1799,28.12,47183968500
817,"Census Tract 9506, Bedford County, Tennessee",3064,53,1.73,3011,22.07,47003950600
818,"Census Tract 9686, Weakley County, Tennessee",1484,36,2.43,1448,33.38,47183968600
819,"Census Tract 9630, Benton County, Tennessee",1124,38,3.38,1086,32.25,47005963000
820,"Census Tract 9631, Benton County, Tennessee",1013,10,0.99,1003,29.62,47005963100
821,"Census Tract 9505, Bedford County, Tennessee",3133,24,0.77,3109,28.03,47003950500
822,"Census Tract 9550, Clay County, Tennessee",1689,42,2.49,1647,31.65,47027955000
823,"Census Tract 9551, Clay County, Tennessee",1012,0,0.0,1012,40.06,47027955100
824,"Census Tract 908, Greene County, Tennessee",1828,9,0.49,1819,25.85,47059090800
825,"Census Tract 904, Greene County, Tennessee",2306,117,5.07,2189,18.23,47059090400
826,"Census Tract 914, Greene County, Tennessee",1201,87,7.24,1114,29.98,47059091400
827,"Census Tract 903, Greene County, Tennessee",2306,41,1.78,2265,24.86,47059090300
828,"Census Tract 906, Greene County, Tennessee",1704,101,5.93,1603,28.15,47059090600
829,"Census Tract 909, Greene County, Tennessee",2277,133,5.84,2144,29.17,47059090900
830,"Census Tract 912, Greene County, Tennessee",1499,21,1.4,1478,30.74,47059091200
831,"Census Tract 211.42, Shelby County, Tennessee",2476,56,2.26,2420,30.28,47157021142
832,"Census Tract 9205, Hardin County, Tennessee",2183,126,5.77,2057,30.81,47071920500
833,"Census Tract 9206, Hardin County, Tennessee",1120,127,11.34,993,32.59,47071920600
834,"Census Tract 503.01, Hawkins County, Tennessee",1588,54,3.4,1534,27.38,47073050301
835,"Census Tract 503.02, Hawkins County, Tennessee",1473,42,2.85,1431,27.65,47073050302
836,"Census Tract 505.01, Hawkins County, Tennessee",1536,29,1.89,1507,33.45,47073050501
837,"Census Tract 505.02, Hawkins County, Tennessee",1075,20,1.86,1055,30.05,47073050502
838,"Census Tract 505.03, Hawkins County, Tennessee",2075,29,1.4,2046,24.48,47073050503
839,"Census Tract 506.01, Hawkins County, Tennessee",2486,28,1.13,2458,25.47,47073050601
840,"Census Tract 506.02, Hawkins County, Tennessee",1851,69,3.73,1782,23.61,47073050602
841,"Census Tract 9301, Haywood County, Tennessee",1122,21,1.87,1101,31.32,47075930100
842,"Census Tract 9302, Haywood County, Tennessee",570,5,0.88,565,30.39,47075930200
843,"Census Tract 9303.01, Haywood County, Tennessee",1685,42,2.49,1643,24.39,47075930301
844,"Census Tract 9303.02, Haywood County, Tennessee",1425,0,0.0,1425,28.45,47075930302
845,"Census Tract 14.01, Madison County, Tennessee",987,15,1.52,972,19.17,47113001401
846,"Census Tract 2, Madison County, Tennessee",2876,15,0.52,2861,17.36,47113000200
847,"Census Tract 10, Madison County, Tennessee",586,0,0.0,586,21.27,47113001000
848,"Census Tract 15.01, Madison County, Tennessee",2610,50,1.92,2560,25.08,47113001501
849,"Census Tract 16.03, Madison County, Tennessee",1255,42,3.35,1213,21.48,47113001603
850,"Census Tract 19, Madison County, Tennessee",1626,9,0.55,1617,30.32,47113001900
851,"Census Tract 16.08, Madison County, Tennessee",1079,8,0.74,1071,26.12,47113001608
852,"Census Tract 223.30, Shelby County, Tennessee",1940,26,1.34,1914,26.24,47157022330
853,"Census Tract 56, Shelby County, Tennessee",1368,0,0.0,1368,27.34,47157005600
854,"Census Tract 57, Shelby County, Tennessee",819,25,3.05,794,30.84,47157005700
855,"Census Tract 78.10, Shelby County, Tennessee",558,7,1.25,551,27.16,47157007810
856,"Census Tract 6, Shelby County, Tennessee",490,22,4.49,468,33.84,47157000600
857,"Census Tract 60, Shelby County, Tennessee",593,4,0.67,589,31.49,47157006000
858,"Census Tract 64, Shelby County, Tennessee",891,28,3.14,863,25.3,47157006400
859,"Census Tract 66, Shelby County, Tennessee",1278,63,4.93,1215,21.31,47157006600
860,"Census Tract 67, Shelby County, Tennessee",1085,13,1.2,1072,25.52,47157006700
861,"Census Tract 103, Shelby County, Tennessee",381,4,1.05,377,33.25,47157010300
862,"Census Tract 72, Shelby County, Tennessee",1881,79,4.2,1802,23.09,47157007200
863,"Census Tract 91, Shelby County, Tennessee",1005,6,0.6,999,29.4,47157009100
864,"Census Tract 89, Shelby County, Tennessee",1719,63,3.66,1656,24.89,47157008900
865,"Census Tract 105, Shelby County, Tennessee",492,10,2.03,482,23.31,47157010500
866,"Census Tract 108.10, Shelby County, Tennessee",2659,32,1.2,2627,24.71,47157010810
867,"Census Tract 70, Shelby County, Tennessee",1540,83,5.39,1457,29.39,47157007000
868,"Census Tract 73, Shelby County, Tennessee",1971,144,7.31,1827,20.29,47157007300
869,"Census Tract 211.37, Shelby County, Tennessee",4290,123,2.87,4167,28.99,47157021137
870,"Census Tract 55, Shelby County, Tennessee",655,0,0.0,655,33.32,47157005500
871,"Census Tract 75, Shelby County, Tennessee",449,0,0.0,449,25.52,47157007500
872,"Census Tract 106.20, Shelby County, Tennessee",1637,24,1.47,1613,27.17,47157010620
873,"Census Tract 9703, Claiborne County, Tennessee",1279,44,3.44,1235,29.13,47025970300
874,"Census Tract 9704, Claiborne County, Tennessee",204,0,0.0,204,31.77,47025970400
875,"Census Tract 9705, Claiborne County, Tennessee",966,39,4.04,927,39.41,47025970500
876,"Census Tract 913, Greene County, Tennessee",1774,23,1.3,1751,29.31,47059091300
877,"Census Tract 911, Greene County, Tennessee",1640,23,1.4,1617,38.54,47059091100
878,"Census Tract 902, Greene County, Tennessee",971,9,0.93,962,22.21,47059090200
879,"Census Tract 907, Greene County, Tennessee",1149,10,0.87,1139,23.79,47059090700
880,"Census Tract 910, Greene County, Tennessee",2983,138,4.63,2845,29.99,47059091000
881,"Census Tract 915, Greene County, Tennessee",1224,53,4.33,1171,35.7,47059091500
882,"Census Tract 905, Greene County, Tennessee",2908,87,2.99,2821,24.61,47059090500
883,"Census Tract 901, Greene County, Tennessee",1785,26,1.46,1759,18.05,47059090100
884,"Census Tract 9702, Cumberland County, Tennessee",3034,91,3.0,2943,31.55,47035970200
885,"Census Tract 9704, Cumberland County, Tennessee",2255,50,2.22,2205,20.15,47035970400
886,"Census Tract 9708, Cumberland County, Tennessee",1497,20,1.34,1477,32.41,47035970800
887,"Census Tract 135, Davidson County, Tennessee",1403,79,5.63,1324,22.92,47037013500
888,"Census Tract 144, Davidson County, Tennessee",751,44,5.86,707,24.66,47037014400
889,"Census Tract 151, Davidson County, Tennessee",2390,132,5.52,2258,27.22,47037015100
890,"Census Tract 155.01, Davidson County, Tennessee",2182,46,2.11,2136,32.74,47037015501
891,"Census Tract 156.09, Davidson County, Tennessee",3091,186,6.02,2905,30.4,47037015609
892,"Census Tract 162, Davidson County, Tennessee",1439,31,2.15,1408,23.84,47037016200
893,"Census Tract 164, Davidson County, Tennessee",1611,189,11.73,1422,18.73,47037016400
894,"Census Tract 190.04, Davidson County, Tennessee",2235,112,5.01,2123,28.93,47037019004
895,"Census Tract 191.11, Davidson County, Tennessee",2708,69,2.55,2639,33.68,47037019111
896,"Census Tract 108.01, Davidson County, Tennessee",3104,93,3.0,3011,33.86,47037010801
897,"Census Tract 111, Davidson County, Tennessee",2606,373,14.31,2233,30.89,47037011100
898,"Census Tract 117, Davidson County, Tennessee",4122,313,7.59,3809,26.82,47037011700
899,"Census Tract 156.13, Davidson County, Tennessee",2050,110,5.37,1940,26.27,47037015613
900,"Census Tract 156.20, Davidson County, Tennessee",3756,24,0.64,3732,38.88,47037015620
901,"Census Tract 161, Davidson County, Tennessee",1328,57,4.29,1271,18.89,47037016100
902,"Census Tract 182.03, Davidson County, Tennessee",695,55,7.91,640,23.9,47037018203
903,"Census Tract 184.05, Davidson County, Tennessee",2516,145,5.76,2371,34.55,47037018405
904,"Census Tract 184.07, Davidson County, Tennessee",2735,284,10.38,2451,36.04,47037018407
905,"Census Tract 182.02, Davidson County, Tennessee",4404,194,4.41,4210,29.92,47037018202
906,"Census Tract 186.01, Davidson County, Tennessee",1126,185,16.43,941,27.08,47037018601
907,"Census Tract 191.08, Davidson County, Tennessee",1733,8,0.46,1725,30.39,47037019108
908,"Census Tract 182.01, Davidson County, Tennessee",1647,74,4.49,1573,29.65,47037018201
909,"Census Tract 189.02, Davidson County, Tennessee",1535,87,5.67,1448,23.74,47037018902
910,"Census Tract 191.10, Davidson County, Tennessee",1998,16,0.8,1982,30.67,47037019110
911,"Census Tract 107.01, Davidson County, Tennessee",2412,75,3.11,2337,30.54,47037010701
912,"Census Tract 153, Davidson County, Tennessee",3099,231,7.45,2868,31.25,47037015300
913,"Census Tract 109.03, Davidson County, Tennessee",2276,72,3.16,2204,27.11,47037010903
914,"Census Tract 139, Davidson County, Tennessee",722,0,0.0,722,25.54,47037013900
915,"Census Tract 189.01, Davidson County, Tennessee",1700,44,2.59,1656,27.15,47037018901
916,"Census Tract 178, Davidson County, Tennessee",4001,319,7.97,3682,22.56,47037017800
917,"Census Tract 159, Davidson County, Tennessee",984,24,2.44,960,24.82,47037015900
918,"Census Tract 133, Davidson County, Tennessee",2334,64,2.74,2270,24.87,47037013300
919,"Census Tract 172, Davidson County, Tennessee",930,55,5.91,875,20.81,47037017200
920,"Census Tract 9701, Claiborne County, Tennessee",991,50,5.05,941,31.06,47025970100
921,"Census Tract 9702, Claiborne County, Tennessee",1142,9,0.79,1133,26.79,47025970200
922,"Census Tract 9707, Claiborne County, Tennessee",1914,41,2.14,1873,25.62,47025970700
923,"Census Tract 9708, Claiborne County, Tennessee",1339,177,13.22,1162,32.53,47025970800
924,"Census Tract 9706, Claiborne County, Tennessee",2022,34,1.68,1988,28.13,47025970600
925,"Census Tract 9709, Claiborne County, Tennessee",1653,8,0.48,1645,31.96,47025970900
926,"Census Tract 9755, Henderson County, Tennessee",1451,32,2.21,1419,33.75,47077975500
927,"Census Tract 9751, Henderson County, Tennessee",1580,52,3.29,1528,35.85,47077975100
928,"Census Tract 9752, Henderson County, Tennessee",2097,151,7.2,1946,37.91,47077975200
929,"Census Tract 9754, Henderson County, Tennessee",1508,80,5.31,1428,29.55,47077975400
930,"Census Tract 9753, Henderson County, Tennessee",3297,137,4.16,3160,29.58,47077975300
931,"Census Tract 9750, Henderson County, Tennessee",1305,17,1.3,1288,29.65,47077975000
932,"Census Tract 9504, Hickman County, Tennessee",836,5,0.6,831,44.08,47081950400
933,"Census Tract 1, Knox County, Tennessee",1335,94,7.04,1241,21.66,47093000100
934,"Census Tract 27, Knox County, Tennessee",947,1,0.11,946,28.13,47093002700
935,"Census Tract 37, Knox County, Tennessee",1352,74,5.47,1278,20.79,47093003700
936,"Census Tract 43, Knox County, Tennessee",1530,30,1.96,1500,27.59,47093004300
937,"Census Tract 17, Knox County, Tennessee",1030,17,1.65,1013,22.99,47093001700
938,"Census Tract 18, Knox County, Tennessee",1119,167,14.92,952,23.06,47093001800
939,"Census Tract 44.01, Knox County, Tennessee",2655,122,4.6,2533,20.82,47093004401
940,"Census Tract 15, Knox County, Tennessee",1799,32,1.78,1767,24.76,47093001500
941,"Census Tract 9701, Lewis County, Tennessee",1845,129,6.99,1716,35.91,47101970100
942,"Census Tract 9702, Lewis County, Tennessee",3010,93,3.09,2917,26.81,47101970200
943,"Census Tract 9703, McMinn County, Tennessee",1418,34,2.4,1384,26.06,47107970300
944,"Census Tract 9705, McMinn County, Tennessee",1521,29,1.91,1492,28.54,47107970500
945,"Census Tract 9706, McMinn County, Tennessee",2428,143,5.89,2285,30.94,47107970600
946,"Census Tract 9708, McMinn County, Tennessee",3033,182,6.0,2851,29.75,47107970800
947,"Census Tract 9702, McMinn County, Tennessee",1815,28,1.54,1787,26.3,47107970200
948,"Census Tract 9707, McMinn County, Tennessee",1573,85,5.4,1488,31.88,47107970700
949,"Census Tract 9550, Marshall County, Tennessee",3428,143,4.17,3285,48.33,47117955000
950,"Census Tract 9551, Marshall County, Tennessee",2502,27,1.08,2475,38.7,47117955100
951,"Census Tract 9554, Marshall County, Tennessee",1568,22,1.4,1546,29.51,47117955400
952,"Census Tract 9553, Marshall County, Tennessee",1652,80,4.84,1572,31.51,47117955300
953,"Census Tract 9552, Marshall County, Tennessee",2583,66,2.56,2517,36.15,47117955200
954,"Census Tract 9555, Marshall County, Tennessee",2037,71,3.49,1966,36.48,47117955500
955,"Census Tract 9653, Obion County, Tennessee",1591,36,2.26,1555,35.74,47131965300
956,"Census Tract 9658, Obion County, Tennessee",746,64,8.58,682,20.63,47131965800
957,"Census Tract 9652, Obion County, Tennessee",837,34,4.06,803,23.68,47131965200
958,"Census Tract 9657, Obion County, Tennessee",2040,45,2.21,1995,20.59,47131965700
959,"Census Tract 9650, Obion County, Tennessee",1911,57,2.98,1854,25.13,47131965000
960,"Census Tract 9654, Obion County, Tennessee",1766,40,2.27,1726,23.47,47131965400
961,"Census Tract 9659, Obion County, Tennessee",489,15,3.07,474,33.46,47131965900
962,"Census Tract 9651, Obion County, Tennessee",948,37,3.9,911,20.69,47131965100
963,"Census Tract 9655, Obion County, Tennessee",901,0,0.0,901,28.34,47131965500
964,"Census Tract 9656, Obion County, Tennessee",1293,0,0.0,1293,22.13,47131965600
965,"Census Tract 184.08, Davidson County, Tennessee",1891,155,8.2,1736,34.96,47037018408
966,"Census Tract 9604, Jackson County, Tennessee",653,12,1.84,641,43.24,47087960400
967,"Census Tract 9602, Jackson County, Tennessee",996,64,6.43,932,40.57,47087960200
968,"Census Tract 9601, Jackson County, Tennessee",529,4,0.76,525,42.84,47087960100
969,"Census Tract 9603, Jackson County, Tennessee",1997,10,0.5,1987,35.87,47087960300
970,"Census Tract 304, Roane County, Tennessee",2765,66,2.39,2699,32.87,47145030400
971,"Census Tract 305, Roane County, Tennessee",1305,17,1.3,1288,27.43,47145030500
972,"Census Tract 302.02, Roane County, Tennessee",2932,219,7.47,2713,33.06,47145030202
973,"Census Tract 308, Roane County, Tennessee",2252,60,2.66,2192,35.75,47145030800
974,"Census Tract 306, Roane County, Tennessee",1439,11,0.76,1428,30.66,47145030600
975,"Census Tract 303, Roane County, Tennessee",2628,123,4.68,2505,44.43,47145030300
976,"Census Tract 309, Roane County, Tennessee",2208,98,4.44,2110,34.51,47145030900
977,"Census Tract 307, Roane County, Tennessee",1350,53,3.93,1297,28.05,47145030700
978,"Census Tract 301, Roane County, Tennessee",1346,74,5.5,1272,29.47,47145030100
979,"Census Tract 302.01, Roane County, Tennessee",2681,65,2.42,2616,33.9,47145030201
980,"Census Tract 114.02, Bradley County, Tennessee",1403,79,5.63,1324,24.45,47011011402
981,"Census Tract 116.01, Bradley County, Tennessee",2028,5,0.25,2023,29.73,47011011601
982,"Census Tract 116.02, Bradley County, Tennessee",2013,45,2.24,1968,33.64,47011011602
983,"Census Tract 9622.01, Carroll County, Tennessee",1045,33,3.16,1012,27.16,47017962201
984,"Census Tract 9622.02, Carroll County, Tennessee",2262,50,2.21,2212,26.74,47017962202
985,"Census Tract 9801, Carroll County, Tennessee",0,0,,0,0.0,47017980100
986,"Census Tract 701.03, Cheatham County, Tennessee",1688,85,5.04,1603,36.94,47021070103
987,"Census Tract 701.04, Cheatham County, Tennessee",2540,54,2.13,2486,35.79,47021070104
988,"Census Tract 702.01, Cheatham County, Tennessee",2305,176,7.64,2129,40.96,47021070201
989,"Census Tract 702.02, Cheatham County, Tennessee",2621,169,6.45,2452,41.26,47021070202
990,"Census Tract 702.03, Cheatham County, Tennessee",1628,32,1.97,1596,42.65,47021070203
991,"Census Tract 704.01, Cheatham County, Tennessee",1259,13,1.03,1246,40.64,47021070401
992,"Census Tract 64.02, Knox County, Tennessee",2528,73,2.89,2455,38.7,47093006402
993,"Census Tract 64.03, Knox County, Tennessee",1527,89,5.83,1438,36.19,47093006403
994,"Census Tract 65.01, Knox County, Tennessee",1318,75,5.69,1243,30.64,47093006501
995,"Census Tract 68, Knox County, Tennessee",1548,37,2.39,1511,27.24,47093006800
996,"Census Tract 65.02, Knox County, Tennessee",1547,100,6.46,1447,29.59,47093006502
997,"Census Tract 66, Knox County, Tennessee",1498,105,7.01,1393,25.81,47093006600
998,"Census Tract 67, Knox County, Tennessee",1239,71,5.73,1168,25.4,47093006700
999,"Census Tract 69, Knox County, Tennessee",3747,215,5.74,3532,19.42,47093006900
1000,"Census Tract 70, Knox County, Tennessee",1151,10,0.87,1141,27.62,47093007000
1001,"Census Tract 71, Knox County, Tennessee",1880,106,5.64,1774,21.36,47093007100
1002,"Census Tract 505.03, Lauderdale County, Tennessee",989,17,1.72,972,28.41,47097050503
1003,"Census Tract 505.04, Lauderdale County, Tennessee",946,6,0.63,940,30.83,47097050504
1004,"Census Tract 505.05, Lauderdale County, Tennessee",1229,8,0.65,1221,26.27,47097050505
1005,"Census Tract 505.06, Lauderdale County, Tennessee",961,5,0.52,956,27.66,47097050506
1006,"Census Tract 9604.01, Lawrence County, Tennessee",1987,56,2.82,1931,26.85,47099960401
1007,"Census Tract 9604.02, Lawrence County, Tennessee",1720,55,3.2,1665,38.04,47099960402
1008,"Census Tract 9605.01, Lawrence County, Tennessee",1316,32,2.43,1284,25.53,47099960501
1009,"Census Tract 9605.02, Lawrence County, Tennessee",1790,45,2.51,1745,30.78,47099960502
1010,"Census Tract 9751, Rhea County, Tennessee",1840,45,2.45,1795,32.75,47143975100
1011,"Census Tract 9753, Rhea County, Tennessee",2071,156,7.53,1915,31.03,47143975300
1012,"Census Tract 9752, Rhea County, Tennessee",2859,43,1.5,2816,30.23,47143975200
1013,"Census Tract 9750, Rhea County, Tennessee",1923,114,5.93,1809,36.59,47143975000
1014,"Census Tract 9752, Scott County, Tennessee",2108,188,8.92,1920,30.21,47151975200
1015,"Census Tract 9753, Scott County, Tennessee",901,2,0.22,899,33.55,47151975300
1016,"Census Tract 9750, Scott County, Tennessee",1435,108,7.53,1327,39.05,47151975000
1017,"Census Tract 9751, Scott County, Tennessee",2392,12,0.5,2380,30.28,47151975100
1018,"Census Tract 9754, Scott County, Tennessee",1169,19,1.63,1150,40.43,47151975400
1019,"Census Tract 409, Tipton County, Tennessee",725,15,2.07,710,40.73,47167040900
1020,"Census Tract 408, Tipton County, Tennessee",2006,73,3.64,1933,38.93,47167040800
1021,"Census Tract 403.02, Tipton County, Tennessee",4955,118,2.38,4837,43.61,47167040302
1022,"Census Tract 404, Tipton County, Tennessee",1389,42,3.02,1347,38.67,47167040400
1023,"Census Tract 405, Tipton County, Tennessee",2942,26,0.88,2916,43.67,47167040500
1024,"Census Tract 406.01, Tipton County, Tennessee",2047,32,1.56,2015,40.26,47167040601
1025,"Census Tract 402, Tipton County, Tennessee",715,20,2.8,695,48.1,47167040200
1026,"Census Tract 406.02, Tipton County, Tennessee",1417,37,2.61,1380,32.35,47167040602
1027,"Census Tract 407, Tipton County, Tennessee",1837,24,1.31,1813,31.14,47167040700
1028,"Census Tract 401, Tipton County, Tennessee",2096,55,2.62,2041,44.6,47167040100
1029,"Census Tract 410, Tipton County, Tennessee",950,10,1.05,940,40.84,47167041000
1030,"Census Tract 204, Anderson County, Tennessee",1843,41,2.22,1802,25.66,47001020400
1031,"Census Tract 206, Anderson County, Tennessee",1130,69,6.11,1061,24.47,47001020600
1032,"Census Tract 209.02, Anderson County, Tennessee",2732,12,0.44,2720,30.13,47001020902
1033,"Census Tract 205, Anderson County, Tennessee",1494,6,0.4,1488,28.16,47001020500
1034,"Census Tract 211, Anderson County, Tennessee",1648,66,4.0,1582,26.77,47001021100
1035,"Census Tract 212.02, Anderson County, Tennessee",2147,23,1.07,2124,26.55,47001021202
1036,"Census Tract 201, Anderson County, Tennessee",1612,143,8.87,1469,25.93,47001020100
1037,"Census Tract 212.01, Anderson County, Tennessee",2185,8,0.37,2177,27.1,47001021201
1038,"Census Tract 209.01, Anderson County, Tennessee",2704,104,3.85,2600,32.85,47001020901
1039,"Census Tract 213.01, Anderson County, Tennessee",1425,44,3.09,1381,31.65,47001021301
1040,"Census Tract 203, Anderson County, Tennessee",1805,79,4.38,1726,25.62,47001020300
1041,"Census Tract 207, Anderson County, Tennessee",514,13,2.53,501,39.37,47001020700
1042,"Census Tract 210, Anderson County, Tennessee",2437,36,1.48,2401,29.0,47001021000
1043,"Census Tract 213.02, Anderson County, Tennessee",3068,79,2.57,2989,29.85,47001021302
1044,"Census Tract 801.02, Sevier County, Tennessee",3298,108,3.27,3190,32.84,47155080102
1045,"Census Tract 802.01, Sevier County, Tennessee",3850,195,5.06,3655,40.02,47155080201
1046,"Census Tract 802.02, Sevier County, Tennessee",2745,248,9.03,2497,40.09,47155080202
1047,"Census Tract 806.01, Sevier County, Tennessee",2126,157,7.38,1969,26.68,47155080601
1048,"Census Tract 806.02, Sevier County, Tennessee",4578,166,3.63,4412,34.01,47155080602
1049,"Census Tract 807.00, Sevier County, Tennessee",3571,180,5.04,3391,32.74,47155080700
1050,"Census Tract 101.04, Hamilton County, Tennessee",1757,90,5.12,1667,43.4,47065010104
1051,"Census Tract 102.01, Hamilton County, Tennessee",1500,66,4.4,1434,36.46,47065010201
1052,"Census Tract 102.02, Hamilton County, Tennessee",1887,37,1.96,1850,40.6,47065010202
1053,"Census Tract 103.03, Hamilton County, Tennessee",1523,28,1.84,1495,30.79,47065010303
1054,"Census Tract 103.04, Hamilton County, Tennessee",2395,184,7.68,2211,31.27,47065010304
1055,"Census Tract 9756.01, Lincoln County, Tennessee",2757,73,2.65,2684,31.78,47103975601
1056,"Census Tract 9756.02, Lincoln County, Tennessee",1576,32,2.03,1544,40.41,47103975602
1057,"Census Tract 602.01, Loudon County, Tennessee",1896,120,6.33,1776,29.96,47105060201
1058,"Census Tract 602.02, Loudon County, Tennessee",3231,34,1.05,3197,22.78,47105060202
1059,"Census Tract 603.01, Loudon County, Tennessee",2263,99,4.37,2164,23.85,47105060301
1060,"Census Tract 603.02, Loudon County, Tennessee",3251,305,9.38,2946,26.56,47105060302
1061,"Census Tract 605.01, Loudon County, Tennessee",1331,134,10.07,1197,36.77,47105060501
1062,"Census Tract 605.02, Loudon County, Tennessee",819,13,1.59,806,27.86,47105060502
1063,"Census Tract 9701.01, McMinn County, Tennessee",2574,114,4.43,2460,33.56,47107970101
1064,"Census Tract 9701.02, McMinn County, Tennessee",2473,31,1.25,2442,25.89,47107970102
1065,"Census Tract 9704.01, McMinn County, Tennessee",1580,65,4.11,1515,20.75,47107970401
1066,"Census Tract 9704.02, McMinn County, Tennessee",2233,102,4.57,2131,23.78,47107970402
1067,"Census Tract 9301, McNairy County, Tennessee",1319,68,5.16,1251,32.07,47109930100
1068,"Census Tract 9302, McNairy County, Tennessee",906,139,15.34,767,37.84,47109930200
1069,"Census Tract 9303, McNairy County, Tennessee",853,23,2.7,830,32.94,47109930300
1070,"Census Tract 9304, McNairy County, Tennessee",732,51,6.97,681,38.36,47109930400
1071,"Census Tract 9305, McNairy County, Tennessee",2592,54,2.08,2538,26.99,47109930500
1072,"Census Tract 9306, McNairy County, Tennessee",1509,23,1.52,1486,32.12,47109930600
1073,"Census Tract 9307, McNairy County, Tennessee",1248,92,7.37,1156,30.16,47109930700
1074,"Census Tract 704.02, Cheatham County, Tennessee",3951,272,6.88,3679,38.63,47021070402
1075,"Census Tract 9201, Cocke County, Tennessee",1493,49,3.28,1444,34.47,47029920100
1076,"Census Tract 9202, Cocke County, Tennessee",2204,36,1.63,2168,22.92,47029920200
1077,"Census Tract 9203, Cocke County, Tennessee",1698,37,2.18,1661,34.82,47029920300
1078,"Census Tract 9204, Cocke County, Tennessee",626,16,2.56,610,55.41,47029920400
1079,"Census Tract 9205.01, Cocke County, Tennessee",2022,13,0.64,2009,29.74,47029920501
1080,"Census Tract 9205.02, Cocke County, Tennessee",2831,28,0.99,2803,39.27,47029920502
1081,"Census Tract 9206, Cocke County, Tennessee",1472,14,0.95,1458,28.86,47029920600
1082,"Census Tract 9207, Cocke County, Tennessee",1492,114,7.64,1378,46.02,47029920700
1083,"Census Tract 9701.01, Cumberland County, Tennessee",629,91,14.47,538,27.12,47035970101
1084,"Census Tract 9708.01, Coffee County, Tennessee",1769,52,2.94,1717,25.51,47031970801
1085,"Census Tract 9708.02, Coffee County, Tennessee",2516,87,3.46,2429,22.81,47031970802
1086,"Census Tract 9801, Coffee County, Tennessee",4,0,0.0,4,14.0,47031980100
1087,"Census Tract 9701.02, Cumberland County, Tennessee",1531,77,5.03,1454,24.9,47035970102
1088,"Census Tract 9703.01, Cumberland County, Tennessee",1123,40,3.56,1083,28.98,47035970301
1089,"Census Tract 208, Anderson County, Tennessee",1726,22,1.27,1704,31.01,47001020800
1090,"Census Tract 9645, Dyer County, Tennessee",1127,37,3.28,1090,29.97,47045964500
1091,"Census Tract 9646, Dyer County, Tennessee",1097,12,1.09,1085,25.41,47045964600
1092,"Census Tract 9642, Dyer County, Tennessee",2540,200,7.87,2340,18.47,47045964200
1093,"Census Tract 9644, Dyer County, Tennessee",2291,8,0.35,2283,25.35,47045964400
1094,"Census Tract 9643, Dyer County, Tennessee",2132,0,0.0,2132,20.13,47045964300
1095,"Census Tract 9640, Dyer County, Tennessee",2755,79,2.87,2676,30.43,47045964000
1096,"Census Tract 9652, Fentress County, Tennessee",1945,162,8.33,1783,30.03,47049965200
1097,"Census Tract 9651, Fentress County, Tennessee",1446,6,0.41,1440,22.67,47049965100
1098,"Census Tract 9650, Fentress County, Tennessee",1218,75,6.16,1143,29.84,47049965000
1099,"Census Tract 103.05, Hamilton County, Tennessee",1571,76,4.84,1495,35.98,47065010305
1100,"Census Tract 103.06, Hamilton County, Tennessee",1748,110,6.29,1638,25.48,47065010306
1101,"Census Tract 103.07, Hamilton County, Tennessee",2339,122,5.22,2217,28.58,47065010307
1102,"Census Tract 104.34, Hamilton County, Tennessee",951,6,0.63,945,27.28,47065010434
1103,"Census Tract 104.35, Hamilton County, Tennessee",2414,134,5.55,2280,30.99,47065010435
1104,"Census Tract 109.01, Hamilton County, Tennessee",1261,79,6.26,1182,19.97,47065010901
1105,"Census Tract 109.02, Hamilton County, Tennessee",442,17,3.85,425,22.74,47065010902
1106,"Census Tract 109.03, Hamilton County, Tennessee",2913,91,3.12,2822,23.96,47065010903
1107,"Census Tract 110.01, Hamilton County, Tennessee",703,38,5.41,665,38.29,47065011001
1108,"Census Tract 110.02, Hamilton County, Tennessee",3478,216,6.21,3262,31.65,47065011002
1109,"Census Tract 112.03, Hamilton County, Tennessee",3793,323,8.52,3470,24.96,47065011203
1110,"Census Tract 112.04, Hamilton County, Tennessee",3000,215,7.17,2785,29.22,47065011204
1111,"Census Tract 113.23, Hamilton County, Tennessee",2845,89,3.13,2756,27.44,47065011323
1112,"Census Tract 113.24, Hamilton County, Tennessee",2126,243,11.43,1883,32.53,47065011324
1113,"Census Tract 113.25, Hamilton County, Tennessee",2733,344,12.59,2389,29.7,47065011325
1114,"Census Tract 113.26, Hamilton County, Tennessee",3147,114,3.62,3033,24.49,47065011326
1115,"Census Tract 114.43, Hamilton County, Tennessee",2862,185,6.46,2677,22.66,47065011443
1116,"Census Tract 114.44, Hamilton County, Tennessee",1258,0,0.0,1258,25.79,47065011444
1117,"Census Tract 114.45, Hamilton County, Tennessee",2045,185,9.05,1860,21.47,47065011445
1118,"Census Tract 114.46, Hamilton County, Tennessee",2249,67,2.98,2182,20.46,47065011446
1119,"Census Tract 114.47, Hamilton County, Tennessee",4138,334,8.07,3804,28.46,47065011447
1120,"Census Tract 122, Hamilton County, Tennessee",688,0,0.0,688,22.5,47065012200
1121,"Census Tract 123, Hamilton County, Tennessee",1897,17,0.9,1880,25.77,47065012300
1122,"Census Tract 124, Hamilton County, Tennessee",2739,155,5.66,2584,16.27,47065012400
1123,"Census Tract 9801, Hamilton County, Tennessee",0,0,,0,0.0,47065980100
1124,"Census Tract 9304, Haywood County, Tennessee",1603,0,0.0,1603,29.19,47075930400
1125,"Census Tract 9305, Haywood County, Tennessee",1155,23,1.99,1132,34.63,47075930500
1126,"Census Tract 9.02, Knox County, Tennessee",1110,203,18.29,907,18.06,47093000902
1127,"Census Tract 9503.01, Hickman County, Tennessee",942,16,1.7,926,41.4,47081950301
1128,"Census Tract 9503.02, Hickman County, Tennessee",1814,30,1.65,1784,40.69,47081950302
1129,"Census Tract 9.01, Knox County, Tennessee",512,64,12.5,448,18.41,47093000901
1130,"Census Tract 38.01, Knox County, Tennessee",2715,77,2.84,2638,21.4,47093003801
1131,"Census Tract 38.02, Knox County, Tennessee",1866,95,5.09,1771,25.56,47093003802
1132,"Census Tract 39.01, Knox County, Tennessee",2224,114,5.13,2110,24.31,47093003901
1133,"Census Tract 39.02, Knox County, Tennessee",1434,25,1.74,1409,21.9,47093003902
1134,"Census Tract 44.03, Knox County, Tennessee",2523,183,7.25,2340,23.93,47093004403
1135,"Census Tract 44.04, Knox County, Tennessee",1957,115,5.88,1842,22.68,47093004404
1136,"Census Tract 46.07, Knox County, Tennessee",3148,148,4.7,3000,27.1,47093004607
1137,"Census Tract 46.08, Knox County, Tennessee",1480,30,2.03,1450,25.35,47093004608
1138,"Census Tract 46.09, Knox County, Tennessee",2705,146,5.4,2559,29.47,47093004609
1139,"Census Tract 46.10, Knox County, Tennessee",2657,95,3.58,2562,20.23,47093004610
1140,"Census Tract 46.11, Knox County, Tennessee",2168,168,7.75,2000,27.66,47093004611
1141,"Census Tract 46.12, Knox County, Tennessee",1599,60,3.75,1539,25.12,47093004612
1142,"Census Tract 46.13, Knox County, Tennessee",3017,165,5.47,2852,24.0,47093004613
1143,"Census Tract 9653, Fentress County, Tennessee",1916,98,5.11,1818,38.32,47049965300
1144,"Census Tract 9663, Gibson County, Tennessee",1150,37,3.22,1113,39.22,47053966300
1145,"Census Tract 9664, Gibson County, Tennessee",2213,0,0.0,2213,25.24,47053966400
1146,"Census Tract 9665, Gibson County, Tennessee",1964,0,0.0,1964,27.74,47053966500
1147,"Census Tract 9666, Gibson County, Tennessee",933,7,0.75,926,29.07,47053966600
1148,"Census Tract 9671, Gibson County, Tennessee",3299,133,4.03,3166,29.05,47053967100
1149,"Census Tract 9668, Gibson County, Tennessee",467,13,2.78,454,33.9,47053966800
1150,"Census Tract 9661, Gibson County, Tennessee",954,67,7.02,887,32.64,47053966100
1151,"Census Tract 9662, Gibson County, Tennessee",1390,25,1.8,1365,29.0,47053966200
1152,"Census Tract 9667, Gibson County, Tennessee",2007,0,0.0,2007,26.06,47053966700
1153,"Census Tract 9669, Gibson County, Tennessee",804,23,2.86,781,19.85,47053966900
1154,"Census Tract 9673, Gibson County, Tennessee",439,0,0.0,439,36.86,47053967300
1155,"Census Tract 9670, Gibson County, Tennessee",2542,35,1.38,2507,20.98,47053967000
1156,"Census Tract 403, Union County, Tennessee",866,88,10.16,778,49.08,47173040300
1157,"Census Tract 402.01, Union County, Tennessee",1526,25,1.64,1501,37.58,47173040201
1158,"Census Tract 402.02, Union County, Tennessee",2190,117,5.34,2073,40.08,47173040202
1159,"Census Tract 401, Union County, Tennessee",2532,121,4.78,2411,39.39,47173040100
1160,"Census Tract 119, Hamilton County, Tennessee",819,33,4.03,786,20.0,47065011900
1161,"Census Tract 114.11, Hamilton County, Tennessee",2020,32,1.58,1988,24.02,47065011411
1162,"Census Tract 4, Hamilton County, Tennessee",1234,8,0.65,1226,22.42,47065000400
1163,"Census Tract 7, Hamilton County, Tennessee",2616,136,5.2,2480,21.36,47065000700
1164,"Census Tract 31, Hamilton County, Tennessee",790,77,9.75,713,16.32,47065003100
1165,"Census Tract 32, Hamilton County, Tennessee",1373,47,3.42,1326,18.98,47065003200
1166,"Census Tract 206.03, Sumner County, Tennessee",1747,67,3.84,1680,38.32,47165020603
1167,"Census Tract 209.03, Sumner County, Tennessee",2146,123,5.73,2023,30.36,47165020903
1168,"Census Tract 210.04, Sumner County, Tennessee",2561,40,1.56,2521,32.63,47165021004
1169,"Census Tract 210.05, Sumner County, Tennessee",3170,203,6.4,2967,30.91,47165021005
1170,"Census Tract 210.06, Sumner County, Tennessee",1901,123,6.47,1778,41.32,47165021006
1171,"Census Tract 210.07, Sumner County, Tennessee",1544,188,12.18,1356,39.01,47165021007
1172,"Census Tract 211.05, Sumner County, Tennessee",4008,196,4.89,3812,30.5,47165021105
1173,"Census Tract 210.08, Sumner County, Tennessee",2906,150,5.16,2756,39.29,47165021008
1174,"Census Tract 210.09, Sumner County, Tennessee",2559,30,1.17,2529,29.69,47165021009
1175,"Census Tract 211.04, Sumner County, Tennessee",1018,15,1.47,1003,36.28,47165021104
1176,"Census Tract 211.06, Sumner County, Tennessee",2251,79,3.51,2172,26.99,47165021106
1177,"Census Tract 211.07, Sumner County, Tennessee",2563,161,6.28,2402,37.86,47165021107
1178,"Census Tract 212.04, Sumner County, Tennessee",3867,242,6.26,3625,34.19,47165021204
1179,"Census Tract 212.05, Sumner County, Tennessee",1319,61,4.62,1258,35.41,47165021205
1180,"Census Tract 403.03, Tipton County, Tennessee",3075,53,1.72,3022,39.72,47167040303
1181,"Census Tract 403.04, Tipton County, Tennessee",2803,0,0.0,2803,47.36,47167040304
1182,"Census Tract 9250, Van Buren County, Tennessee",1034,122,11.8,912,38.45,47175925000
1183,"Census Tract 9252, Van Buren County, Tennessee",1047,71,6.78,976,31.83,47175925200
1184,"Census Tract 9301, Warren County, Tennessee",1643,54,3.29,1589,29.54,47177930100
1185,"Census Tract 9302, Warren County, Tennessee",2990,115,3.85,2875,30.83,47177930200
1186,"Census Tract 9303, Warren County, Tennessee",1075,74,6.88,1001,44.3,47177930300
1187,"Census Tract 9304, Warren County, Tennessee",2266,89,3.93,2177,29.1,47177930400
1188,"Census Tract 9305, Warren County, Tennessee",1710,57,3.33,1653,26.25,47177930500
1189,"Census Tract 9306, Warren County, Tennessee",1509,82,5.43,1427,29.98,47177930600
1190,"Census Tract 9307, Warren County, Tennessee",2172,62,2.85,2110,23.69,47177930700
1191,"Census Tract 9308, Warren County, Tennessee",2589,67,2.59,2522,29.88,47177930800
1192,"Census Tract 9309, Warren County, Tennessee",647,45,6.96,602,31.81,47177930900
1193,"Census Tract 605.01, Washington County, Tennessee",2036,50,2.46,1986,23.15,47179060501
1194,"Census Tract 605.02, Washington County, Tennessee",2874,24,0.84,2850,23.03,47179060502
1195,"Census Tract 614.01, Washington County, Tennessee",2362,117,4.95,2245,24.49,47179061401
1196,"Census Tract 614.02, Washington County, Tennessee",3343,196,5.86,3147,23.26,47179061402
1197,"Census Tract 616.01, Washington County, Tennessee",2102,139,6.61,1963,29.47,47179061601
1198,"Census Tract 616.02, Washington County, Tennessee",3813,146,3.83,3667,26.06,47179061602
1199,"Census Tract 617.01, Washington County, Tennessee",2883,377,13.08,2506,30.2,47179061701
1200,"Census Tract 617.02, Washington County, Tennessee",3313,224,6.76,3089,26.37,47179061702
1201,"Census Tract 619.01, Washington County, Tennessee",2981,54,1.81,2927,33.84,47179061901
1202,"Census Tract 619.02, Washington County, Tennessee",2385,93,3.9,2292,31.03,47179061902
1203,"Census Tract 620, Washington County, Tennessee",1712,65,3.8,1647,23.88,47179062000
1204,"Census Tract 9681.01, Weakley County, Tennessee",1658,26,1.57,1632,21.53,47183968101
1205,"Census Tract 9681.02, Weakley County, Tennessee",914,31,3.39,883,25.26,47183968102
1206,"Census Tract 9682.01, Weakley County, Tennessee",2180,16,0.73,2164,19.31,47183968201
1207,"Census Tract 9682.02, Weakley County, Tennessee",658,30,4.56,628,19.27,47183968202
1208,"Census Tract 112.01, Hamilton County, Tennessee",5569,606,10.88,4963,30.86,47065011201
1209,"Census Tract 113.11, Hamilton County, Tennessee",3772,324,8.59,3448,23.73,47065011311
1210,"Census Tract 113.14, Hamilton County, Tennessee",2478,169,6.82,2309,26.41,47065011314
1211,"Census Tract 116, Hamilton County, Tennessee",2613,50,1.91,2563,22.26,47065011600
1212,"Census Tract 14, Hamilton County, Tennessee",872,51,5.85,821,19.96,47065001400
1213,"Census Tract 18, Hamilton County, Tennessee",1395,79,5.66,1316,22.76,47065001800
1214,"Census Tract 26, Hamilton County, Tennessee",813,63,7.75,750,18.83,47065002600
1215,"Census Tract 104.31, Hamilton County, Tennessee",3239,214,6.61,3025,25.54,47065010431
1216,"Census Tract 28, Hamilton County, Tennessee",2038,125,6.13,1913,20.67,47065002800
1217,"Census Tract 114.02, Hamilton County, Tennessee",3223,97,3.01,3126,20.17,47065011402
1218,"Census Tract 106, Hamilton County, Tennessee",1439,39,2.71,1400,22.62,47065010600
1219,"Census Tract 23, Hamilton County, Tennessee",571,25,4.38,546,20.97,47065002300
1220,"Census Tract 29, Hamilton County, Tennessee",1362,37,2.72,1325,22.35,47065002900
1221,"Census Tract 12, Hamilton County, Tennessee",1083,49,4.52,1034,19.76,47065001200
1222,"Census Tract 25, Hamilton County, Tennessee",1651,28,1.7,1623,22.2,47065002500
1223,"Census Tract 104.33, Hamilton County, Tennessee",2093,33,1.58,2060,25.3,47065010433
1224,"Census Tract 108, Hamilton County, Tennessee",2056,69,3.36,1987,21.94,47065010800
1225,"Census Tract 19, Hamilton County, Tennessee",1394,37,2.65,1357,22.96,47065001900
1226,"Census Tract 104.11, Hamilton County, Tennessee",3389,158,4.66,3231,28.41,47065010411
1227,"Census Tract 1014, Montgomery County, Tennessee",2959,51,1.72,2908,14.15,47125101400
1228,"Census Tract 1018.02, Montgomery County, Tennessee",5340,248,4.64,5092,33.23,47125101802
1229,"Census Tract 1019.02, Montgomery County, Tennessee",1098,30,2.73,1068,29.08,47125101902
1230,"Census Tract 1016, Montgomery County, Tennessee",2515,45,1.79,2470,34.79,47125101600
1231,"Census Tract 1006.01, Montgomery County, Tennessee",1017,45,4.42,972,24.65,47125100601
1232,"Census Tract 1009, Montgomery County, Tennessee",1337,11,0.82,1326,40.42,47125100900
1233,"Census Tract 1010.01, Montgomery County, Tennessee",1744,0,0.0,1744,42.34,47125101001
1234,"Census Tract 1007, Montgomery County, Tennessee",552,48,8.7,504,27.05,47125100700
1235,"Census Tract 1008, Montgomery County, Tennessee",1016,12,1.18,1004,26.41,47125100800
1236,"Census Tract 1017, Montgomery County, Tennessee",3644,99,2.72,3545,43.93,47125101700
1237,"Census Tract 1003, Montgomery County, Tennessee",2332,53,2.27,2279,30.82,47125100300
1238,"Census Tract 1004, Montgomery County, Tennessee",1320,28,2.12,1292,28.68,47125100400
1239,"Census Tract 1006.02, Montgomery County, Tennessee",1296,9,0.69,1287,27.58,47125100602
1240,"Census Tract 1011.01, Montgomery County, Tennessee",1064,72,6.77,992,29.95,47125101101
1241,"Census Tract 1011.03, Montgomery County, Tennessee",1078,23,2.13,1055,41.68,47125101103
1242,"Census Tract 1001, Montgomery County, Tennessee",453,5,1.1,448,28.83,47125100100
1243,"Census Tract 1002, Montgomery County, Tennessee",678,26,3.83,652,29.62,47125100200
1244,"Census Tract 1005, Montgomery County, Tennessee",2280,9,0.39,2271,26.26,47125100500
1245,"Census Tract 1011.02, Montgomery County, Tennessee",3544,13,0.37,3531,32.92,47125101102
1246,"Census Tract 1015, Montgomery County, Tennessee",3220,24,0.75,3196,37.97,47125101500
1247,"Census Tract 1010.02, Montgomery County, Tennessee",1686,126,7.47,1560,32.86,47125101002
1248,"Census Tract 607, Dickson County, Tennessee",1870,112,5.99,1758,50.06,47043060700
1249,"Census Tract 601, Dickson County, Tennessee",1759,71,4.04,1688,48.43,47043060100
1250,"Census Tract 602, Dickson County, Tennessee",2403,92,3.83,2311,47.39,47043060200
1251,"Census Tract 603, Dickson County, Tennessee",2939,111,3.78,2828,46.69,47043060300
1252,"Census Tract 107, Hamilton County, Tennessee",1416,99,6.99,1317,22.75,47065010700
1253,"Census Tract 111, Hamilton County, Tennessee",2496,226,9.05,2270,27.11,47065011100
1254,"Census Tract 118, Hamilton County, Tennessee",3266,54,1.65,3212,20.65,47065011800
1255,"Census Tract 8, Hamilton County, Tennessee",911,100,10.98,811,21.45,47065000800
1256,"Census Tract 33, Hamilton County, Tennessee",2519,133,5.28,2386,29.86,47065003300
1257,"Census Tract 34, Hamilton County, Tennessee",2109,58,2.75,2051,22.95,47065003400
1258,"Census Tract 113.21, Hamilton County, Tennessee",4232,212,5.01,4020,24.5,47065011321
1259,"Census Tract 120, Hamilton County, Tennessee",878,81,9.23,797,24.57,47065012000
1260,"Census Tract 16, Hamilton County, Tennessee",543,0,0.0,543,27.96,47065001600
1261,"Census Tract 121, Hamilton County, Tennessee",3146,125,3.97,3021,21.26,47065012100
1262,"Census Tract 6, Hamilton County, Tennessee",1815,202,11.13,1613,20.09,47065000600
1263,"Census Tract 11, Hamilton County, Tennessee",812,54,6.65,758,24.8,47065001100
1264,"Census Tract 24, Hamilton County, Tennessee",1568,66,4.21,1502,29.16,47065002400
1265,"Census Tract 30, Hamilton County, Tennessee",1117,30,2.69,1087,20.86,47065003000
1266,"Census Tract 9682.03, Weakley County, Tennessee",1408,0,0.0,1408,18.61,47183968203
1267,"Census Tract 9350, White County, Tennessee",1467,41,2.79,1426,33.37,47185935000
1268,"Census Tract 9351, White County, Tennessee",2193,28,1.28,2165,27.35,47185935100
1269,"Census Tract 9352, White County, Tennessee",1669,83,4.97,1586,31.84,47185935200
1270,"Census Tract 9353, White County, Tennessee",1914,66,3.45,1848,27.58,47185935300
1271,"Census Tract 9354, White County, Tennessee",1216,42,3.45,1174,21.39,47185935400
1272,"Census Tract 9355, White County, Tennessee",1344,47,3.5,1297,33.06,47185935500
1273,"Census Tract 501.01, Williamson County, Tennessee",4655,477,10.25,4178,36.54,47187050101
1274,"Census Tract 501.02, Williamson County, Tennessee",2355,272,11.55,2083,39.77,47187050102
1275,"Census Tract 501.03, Williamson County, Tennessee",2564,219,8.54,2345,35.8,47187050103
1276,"Census Tract 502.03, Williamson County, Tennessee",2563,111,4.33,2452,28.32,47187050203
1277,"Census Tract 502.04, Williamson County, Tennessee",2573,225,8.74,2348,32.64,47187050204
1278,"Census Tract 502.05, Williamson County, Tennessee",1675,138,8.24,1537,27.53,47187050205
1279,"Census Tract 502.06, Williamson County, Tennessee",1400,208,14.86,1192,31.21,47187050206
1280,"Census Tract 502.07, Williamson County, Tennessee",2039,219,10.74,1820,33.89,47187050207
1281,"Census Tract 502.08, Williamson County, Tennessee",4481,269,6.0,4212,25.98,47187050208
1282,"Census Tract 503.03, Williamson County, Tennessee",1368,82,5.99,1286,26.53,47187050303
1283,"Census Tract 503.04, Williamson County, Tennessee",1007,122,12.12,885,29.05,47187050304
1284,"Census Tract 503.05, Williamson County, Tennessee",1315,83,6.31,1232,24.69,47187050305
1285,"Census Tract 503.06, Williamson County, Tennessee",1118,98,8.77,1020,25.6,47187050306
1286,"Census Tract 503.07, Williamson County, Tennessee",2269,204,8.99,2065,23.55,47187050307
1287,"Census Tract 504.03, Williamson County, Tennessee",1007,134,13.31,873,36.48,47187050403
1288,"Census Tract 504.04, Williamson County, Tennessee",3117,361,11.58,2756,33.38,47187050404
1289,"Census Tract 504.05, Williamson County, Tennessee",1298,178,13.71,1120,35.26,47187050405
1290,"Census Tract 504.06, Williamson County, Tennessee",3046,398,13.07,2648,30.29,47187050406
1291,"Census Tract 505.03, Williamson County, Tennessee",2593,196,7.56,2397,44.79,47187050503
1292,"Census Tract 505.04, Williamson County, Tennessee",2159,137,6.35,2022,43.81,47187050504
1293,"Census Tract 506.01, Williamson County, Tennessee",3344,304,9.09,3040,28.59,47187050601
1294,"Census Tract 506.02, Williamson County, Tennessee",4826,637,13.2,4189,36.03,47187050602
1295,"Census Tract 507.01, Williamson County, Tennessee",2183,167,7.65,2016,32.05,47187050701
1296,"Census Tract 507.02, Williamson County, Tennessee",2188,331,15.13,1857,29.04,47187050702
1297,"Census Tract 509.04, Williamson County, Tennessee",3380,128,3.79,3252,23.45,47187050904
1298,"Census Tract 509.05, Williamson County, Tennessee",3591,177,4.93,3414,26.6,47187050905
1299,"Census Tract 509.06, Williamson County, Tennessee",2929,313,10.69,2616,31.53,47187050906
1300,"Census Tract 509.07, Williamson County, Tennessee",3041,240,7.89,2801,32.88,47187050907
1301,"Census Tract 509.08, Williamson County, Tennessee",1867,279,14.94,1588,38.71,47187050908
1302,"Census Tract 509.09, Williamson County, Tennessee",2018,162,8.03,1856,33.09,47187050909
1303,"Census Tract 510.01, Williamson County, Tennessee",3638,403,11.08,3235,30.52,47187051001
1304,"Census Tract 512.02, Williamson County, Tennessee",13936,1463,10.5,12473,40.14,47187051202
1305,"Census Tract 510.02, Williamson County, Tennessee",3963,685,17.28,3278,31.41,47187051002
1306,"Census Tract 511.00, Williamson County, Tennessee",4070,418,10.27,3652,37.63,47187051100
1307,"Census Tract 512.01, Williamson County, Tennessee",3756,476,12.67,3280,40.05,47187051201
1308,"Census Tract 302.03, Wilson County, Tennessee",2826,208,7.36,2618,42.2,47189030203
1309,"Census Tract 302.04, Wilson County, Tennessee",3949,178,4.51,3771,41.54,47189030204
1310,"Census Tract 303.08, Wilson County, Tennessee",2634,167,6.34,2467,39.01,47189030308
1311,"Census Tract 303.09, Wilson County, Tennessee",2433,261,10.73,2172,34.65,47189030309
1312,"Census Tract 304.01, Wilson County, Tennessee",1057,61,5.77,996,32.72,47189030401
1313,"Census Tract 304.02, Wilson County, Tennessee",2045,20,0.98,2025,26.93,47189030402
1314,"Census Tract 309.03, Wilson County, Tennessee",4720,387,8.2,4333,38.76,47189030903
1315,"Census Tract 309.04, Wilson County, Tennessee",2105,181,8.6,1924,45.1,47189030904
1316,"Census Tract 423, Rutherford County, Tennessee",4592,114,2.48,4478,34.03,47149042300
1317,"Census Tract 9703.02, Cumberland County, Tennessee",1504,80,5.32,1424,32.13,47035970302
1318,"Census Tract 9705.01, Cumberland County, Tennessee",1063,9,0.85,1054,25.35,47035970501
1319,"Census Tract 9705.02, Cumberland County, Tennessee",1370,29,2.12,1341,15.95,47035970502
1320,"Census Tract 9706.01, Cumberland County, Tennessee",2082,52,2.5,2030,23.71,47035970601
1321,"Census Tract 9706.02, Cumberland County, Tennessee",1409,20,1.42,1389,27.88,47035970602
1322,"Census Tract 9706.03, Cumberland County, Tennessee",820,35,4.27,785,25.58,47035970603
1323,"Census Tract 9707.01, Cumberland County, Tennessee",881,28,3.18,853,29.03,47035970701
1324,"Census Tract 9707.02, Cumberland County, Tennessee",1716,63,3.67,1653,36.79,47035970702
1325,"Census Tract 101.03, Davidson County, Tennessee",1159,42,3.62,1117,38.94,47037010103
1326,"Census Tract 101.04, Davidson County, Tennessee",1441,97,6.73,1344,34.32,47037010104
1327,"Census Tract 101.05, Davidson County, Tennessee",1856,126,6.79,1730,29.61,47037010105
1328,"Census Tract 101.06, Davidson County, Tennessee",1626,23,1.41,1603,28.22,47037010106
1329,"Census Tract 102.01, Davidson County, Tennessee",2301,150,6.52,2151,34.15,47037010201
1330,"Census Tract 102.02, Davidson County, Tennessee",1863,205,11.0,1658,35.44,47037010202
1331,"Census Tract 103.03, Davidson County, Tennessee",2617,156,5.96,2461,29.09,47037010303
1332,"Census Tract 106.01, Davidson County, Tennessee",2643,83,3.14,2560,32.42,47037010601
1333,"Census Tract 106.02, Davidson County, Tennessee",1952,111,5.69,1841,39.63,47037010602
1334,"Census Tract 132.01, Davidson County, Tennessee",1615,73,4.52,1542,24.42,47037013201
1335,"Census Tract 132.02, Davidson County, Tennessee",1987,144,7.25,1843,24.92,47037013202
1336,"Census Tract 136.01, Davidson County, Tennessee",1423,36,2.53,1387,26.52,47037013601
1337,"Census Tract 136.02, Davidson County, Tennessee",720,37,5.14,683,19.7,47037013602
1338,"Census Tract 156.22, Davidson County, Tennessee",2469,173,7.01,2296,33.82,47037015622
1339,"Census Tract 501.01, Marion County, Tennessee",1572,51,3.24,1521,41.48,47115050101
1340,"Census Tract 501.02, Marion County, Tennessee",2327,86,3.7,2241,43.59,47115050102
1341,"Census Tract 502.01, Marion County, Tennessee",2171,46,2.12,2125,31.6,47115050201
1342,"Census Tract 502.02, Marion County, Tennessee",2669,330,12.36,2339,38.56,47115050202
1343,"Census Tract 503.01, Marion County, Tennessee",2110,74,3.51,2036,23.72,47115050301
1344,"Census Tract 503.02, Marion County, Tennessee",1360,36,2.65,1324,34.23,47115050302
1345,"Census Tract 102.01, Maury County, Tennessee",3489,244,6.99,3245,39.9,47119010201
1346,"Census Tract 102.02, Maury County, Tennessee",5541,227,4.1,5314,37.75,47119010202
1347,"Census Tract 103.01, Maury County, Tennessee",3548,161,4.54,3387,36.81,47119010301
1348,"Census Tract 110.01, Maury County, Tennessee",1372,33,2.41,1339,35.63,47119011001
1349,"Census Tract 103.02, Maury County, Tennessee",1428,72,5.04,1356,35.87,47119010302
1350,"Census Tract 108.01, Maury County, Tennessee",1872,31,1.66,1841,30.47,47119010801
1351,"Census Tract 108.02, Maury County, Tennessee",3005,38,1.26,2967,33.4,47119010802
1352,"Census Tract 110.02, Maury County, Tennessee",3004,0,0.0,3004,37.36,47119011002
1353,"Census Tract 111.01, Maury County, Tennessee",2302,108,4.69,2194,31.76,47119011101
1354,"Census Tract 111.02, Maury County, Tennessee",1394,81,5.81,1313,27.59,47119011102
1355,"Census Tract 9250, Monroe County, Tennessee",2837,104,3.67,2733,33.03,47123925000
1356,"Census Tract 9251, Monroe County, Tennessee",3251,35,1.08,3216,27.75,47123925100
1357,"Census Tract 9252, Monroe County, Tennessee",1428,11,0.77,1417,28.78,47123925200
1358,"Census Tract 9253, Monroe County, Tennessee",2780,0,0.0,2780,36.13,47123925300
1359,"Census Tract 9254, Monroe County, Tennessee",3339,189,5.66,3150,32.96,47123925400
1360,"Census Tract 9255.01, Monroe County, Tennessee",1125,99,8.8,1026,43.86,47123925501
1361,"Census Tract 9255.02, Monroe County, Tennessee",1890,15,0.79,1875,44.0,47123925502
1362,"Census Tract 1012.01, Montgomery County, Tennessee",859,16,1.86,843,34.95,47125101201
1363,"Census Tract 1012.02, Montgomery County, Tennessee",1827,59,3.23,1768,28.99,47125101202
1364,"Census Tract 1013.03, Montgomery County, Tennessee",5168,121,2.34,5047,28.85,47125101303
1365,"Census Tract 1013.04, Montgomery County, Tennessee",2713,39,1.44,2674,23.71,47125101304
1366,"Census Tract 1013.05, Montgomery County, Tennessee",2335,131,5.61,2204,29.88,47125101305
1367,"Census Tract 1013.06, Montgomery County, Tennessee",2704,73,2.7,2631,30.27,47125101306
1368,"Census Tract 1013.07, Montgomery County, Tennessee",1110,23,2.07,1087,29.02,47125101307
1369,"Census Tract 1018.03, Montgomery County, Tennessee",2980,57,1.91,2923,37.75,47125101803
1370,"Census Tract 1018.04, Montgomery County, Tennessee",3558,100,2.81,3458,31.11,47125101804
1371,"Census Tract 1019.03, Montgomery County, Tennessee",5243,88,1.68,5155,27.66,47125101903
1372,"Census Tract 1019.04, Montgomery County, Tennessee",1939,148,7.63,1791,30.89,47125101904
1373,"Census Tract 1020.01, Montgomery County, Tennessee",2947,45,1.53,2902,27.9,47125102001
1374,"Census Tract 1020.02, Montgomery County, Tennessee",4116,92,2.24,4024,32.14,47125102002
1375,"Census Tract 1020.03, Montgomery County, Tennessee",3453,136,3.94,3317,28.88,47125102003
1376,"Census Tract 156.23, Davidson County, Tennessee",2624,124,4.73,2500,33.67,47037015623
1377,"Census Tract 156.24, Davidson County, Tennessee",3217,197,6.12,3020,33.89,47037015624
1378,"Census Tract 156.25, Davidson County, Tennessee",2816,210,7.46,2606,30.12,47037015625
1379,"Census Tract 156.26, Davidson County, Tennessee",3791,26,0.69,3765,32.78,47037015626
1380,"Census Tract 156.27, Davidson County, Tennessee",1486,35,2.36,1451,33.51,47037015627
1381,"Census Tract 156.28, Davidson County, Tennessee",2282,120,5.26,2162,32.68,47037015628
1382,"Census Tract 156.29, Davidson County, Tennessee",4310,0,0.0,4310,33.73,47037015629
1383,"Census Tract 156.30, Davidson County, Tennessee",2735,72,2.63,2663,37.46,47037015630
1384,"Census Tract 156.31, Davidson County, Tennessee",6055,300,4.95,5755,40.27,47037015631
1385,"Census Tract 158.03, Davidson County, Tennessee",1717,0,0.0,1717,25.79,47037015803
1386,"Census Tract 158.04, Davidson County, Tennessee",2919,82,2.81,2837,26.2,47037015804
1387,"Census Tract 177.01, Davidson County, Tennessee",1326,110,8.3,1216,22.88,47037017701
1388,"Census Tract 177.02, Davidson County, Tennessee",2746,179,6.52,2567,18.96,47037017702
1389,"Census Tract 183.01, Davidson County, Tennessee",4477,271,6.05,4206,29.68,47037018301
1390,"Census Tract 183.02, Davidson County, Tennessee",1404,89,6.34,1315,36.55,47037018302
1391,"Census Tract 184.09, Davidson County, Tennessee",2335,107,4.58,2228,33.33,47037018409
1392,"Census Tract 184.10, Davidson County, Tennessee",2013,118,5.86,1895,29.51,47037018410
1393,"Census Tract 189.05, Davidson County, Tennessee",1847,25,1.35,1822,29.73,47037018905
1394,"Census Tract 188.03, Davidson County, Tennessee",2051,184,8.97,1867,26.19,47037018803
1395,"Census Tract 188.04, Davidson County, Tennessee",2935,255,8.69,2680,29.29,47037018804
1396,"Census Tract 189.04, Davidson County, Tennessee",2241,96,4.28,2145,35.07,47037018904
1397,"Census Tract 190.05, Davidson County, Tennessee",1569,77,4.91,1492,29.59,47037019005
1398,"Census Tract 190.06, Davidson County, Tennessee",2498,45,1.8,2453,30.93,47037019006
1399,"Census Tract 191.15, Davidson County, Tennessee",2240,249,11.12,1991,34.75,47037019115
1400,"Census Tract 191.16, Davidson County, Tennessee",3573,231,6.47,3342,33.72,47037019116
1401,"Census Tract 191.17, Davidson County, Tennessee",2756,147,5.33,2609,39.78,47037019117
1402,"Census Tract 191.18, Davidson County, Tennessee",4009,211,5.26,3798,32.58,47037019118
1403,"Census Tract 192, Davidson County, Tennessee",2062,392,19.01,1670,23.44,47037019200
1404,"Census Tract 193, Davidson County, Tennessee",869,0,0.0,869,21.87,47037019300
1405,"Census Tract 194, Davidson County, Tennessee",3321,330,9.94,2991,22.99,47037019400
1406,"Census Tract 195, Davidson County, Tennessee",5021,512,10.2,4509,19.83,47037019500
1407,"Census Tract 196, Davidson County, Tennessee",2571,155,6.03,2416,27.98,47037019600
1408,"Census Tract 9801, Davidson County, Tennessee",0,0,,0,0.0,47037980100
1409,"Census Tract 9802, Davidson County, Tennessee",0,0,,0,0.0,47037980200
1410,"Census Tract 9550.01, Decatur County, Tennessee",725,27,3.72,698,33.81,47039955001
1411,"Census Tract 9550.02, Decatur County, Tennessee",1609,119,7.4,1490,23.21,47039955002
1412,"Census Tract 9551.01, Decatur County, Tennessee",733,74,10.1,659,43.2,47039955101
1413,"Census Tract 1020.04, Montgomery County, Tennessee",3116,70,2.25,3046,28.02,47125102004
1414,"Census Tract 1020.05, Montgomery County, Tennessee",2691,100,3.72,2591,29.93,47125102005
1415,"Census Tract 1020.06, Montgomery County, Tennessee",3669,78,2.13,3591,35.98,47125102006
1416,"Census Tract 9801, Montgomery County, Tennessee",291,0,0.0,291,9.24,47125980100
1417,"Census Tract 9301, Moore County, Tennessee",1672,40,2.39,1632,31.33,47127930100
1418,"Census Tract 9302, Moore County, Tennessee",1074,78,7.26,996,36.99,47127930200
1419,"Census Tract 9503.01, Overton County, Tennessee",1642,91,5.54,1551,26.64,47133950301
1420,"Census Tract 9503.02, Overton County, Tennessee",1208,28,2.32,1180,27.34,47133950302
1421,"Census Tract 9301, Perry County, Tennessee",999,70,7.01,929,36.18,47135930100
1422,"Census Tract 9302, Perry County, Tennessee",1677,221,13.18,1456,30.45,47135930200
1423,"Census Tract 9251, Pickett County, Tennessee",1928,110,5.71,1818,30.42,47137925100
1424,"Census Tract 9502.01, Polk County, Tennessee",948,74,7.81,874,42.52,47139950201
1425,"Census Tract 9502.02, Polk County, Tennessee",2392,15,0.63,2377,34.83,47139950202
1426,"Census Tract 3.01, Putnam County, Tennessee",1185,32,2.7,1153,29.57,47141000301
1427,"Census Tract 3.02, Putnam County, Tennessee",3490,68,1.95,3422,23.58,47141000302
1428,"Census Tract 3.03, Putnam County, Tennessee",1032,32,3.1,1000,27.32,47141000303
1429,"Census Tract 9754.01, Rhea County, Tennessee",2652,36,1.36,2616,19.64,47143975401
1430,"Census Tract 9754.02, Rhea County, Tennessee",1475,54,3.66,1421,24.61,47143975402
1431,"Census Tract 9801, Roane County, Tennessee",0,0,,0,0.0,47145980100
1432,"Census Tract 801.03, Robertson County, Tennessee",3270,97,2.97,3173,37.03,47147080103
1433,"Census Tract 801.04, Robertson County, Tennessee",3546,213,6.01,3333,37.89,47147080104
1434,"Census Tract 803.01, Robertson County, Tennessee",1078,15,1.39,1063,31.65,47147080301
1435,"Census Tract 803.02, Robertson County, Tennessee",1307,38,2.91,1269,27.38,47147080302
1436,"Census Tract 806.03, Robertson County, Tennessee",2184,71,3.25,2113,37.88,47147080603
1437,"Census Tract 401.01, Rutherford County, Tennessee",1679,6,0.36,1673,38.93,47149040101
1438,"Census Tract 806.04, Robertson County, Tennessee",1843,86,4.67,1757,37.03,47147080604
1439,"Census Tract 806.05, Robertson County, Tennessee",1524,67,4.4,1457,43.88,47147080605
1440,"Census Tract 806.06, Robertson County, Tennessee",3010,189,6.28,2821,36.91,47147080606
1441,"Census Tract 401.02, Rutherford County, Tennessee",1959,41,2.09,1918,42.97,47149040102
1442,"Census Tract 401.03, Rutherford County, Tennessee",4264,186,4.36,4078,45.05,47149040103
1443,"Census Tract 401.04, Rutherford County, Tennessee",2847,118,4.14,2729,41.29,47149040104
1444,"Census Tract 401.05, Rutherford County, Tennessee",2163,29,1.34,2134,41.6,47149040105
1445,"Census Tract 403.03, Rutherford County, Tennessee",1155,24,2.08,1131,38.23,47149040303
1446,"Census Tract 403.04, Rutherford County, Tennessee",1466,27,1.84,1439,37.75,47149040304
1447,"Census Tract 403.05, Rutherford County, Tennessee",1348,99,7.34,1249,29.99,47149040305
1448,"Census Tract 403.06, Rutherford County, Tennessee",3373,64,1.9,3309,29.11,47149040306
1449,"Census Tract 403.07, Rutherford County, Tennessee",1676,141,8.41,1535,35.15,47149040307
1450,"Census Tract 9551.02, Decatur County, Tennessee",1339,92,6.87,1247,35.07,47039955102
1451,"Census Tract 9201.01, DeKalb County, Tennessee",972,63,6.48,909,37.12,47041920101
1452,"Census Tract 9201.02, DeKalb County, Tennessee",2245,18,0.8,2227,33.53,47041920102
1453,"Census Tract 9202, DeKalb County, Tennessee",2210,18,0.81,2192,30.1,47041920200
1454,"Census Tract 9203, DeKalb County, Tennessee",2378,53,2.23,2325,43.61,47041920300
1455,"Census Tract 604.01, Dickson County, Tennessee",1746,62,3.55,1684,39.84,47043060401
1456,"Census Tract 604.02, Dickson County, Tennessee",3115,105,3.37,3010,39.76,47043060402
1457,"Census Tract 605.01, Dickson County, Tennessee",3113,60,1.93,3053,31.13,47043060501
1458,"Census Tract 605.02, Dickson County, Tennessee",1146,50,4.36,1096,33.22,47043060502
1459,"Census Tract 606.01, Dickson County, Tennessee",1691,41,2.42,1650,35.48,47043060601
1460,"Census Tract 606.02, Dickson County, Tennessee",2791,11,0.39,2780,35.31,47043060602
1461,"Census Tract 9648, Dyer County, Tennessee",1449,43,2.97,1406,28.28,47045964800
1462,"Census Tract 9649, Dyer County, Tennessee",2323,45,1.94,2278,26.1,47045964900
1463,"Census Tract 604.01, Fayette County, Tennessee",1334,180,13.49,1154,39.77,47047060401
1464,"Census Tract 604.02, Fayette County, Tennessee",1830,103,5.63,1727,41.1,47047060402
1465,"Census Tract 604.03, Fayette County, Tennessee",1946,47,2.42,1899,40.83,47047060403
1466,"Census Tract 604.04, Fayette County, Tennessee",2884,24,0.83,2860,45.71,47047060404
1467,"Census Tract 605.01, Fayette County, Tennessee",1443,72,4.99,1371,36.29,47047060501
1468,"Census Tract 605.02, Fayette County, Tennessee",1627,41,2.52,1586,39.42,47047060502
1469,"Census Tract 607.01, Fayette County, Tennessee",1033,69,6.68,964,40.75,47047060701
1470,"Census Tract 607.02, Fayette County, Tennessee",1481,96,6.48,1385,31.13,47047060702
1471,"Census Tract 608, Fayette County, Tennessee",1010,30,2.97,980,33.54,47047060800
1472,"Census Tract 9602.01, Franklin County, Tennessee",2922,145,4.96,2777,27.76,47051960201
1473,"Census Tract 9602.02, Franklin County, Tennessee",2375,41,1.73,2334,26.2,47051960202
1474,"Census Tract 9674, Gibson County, Tennessee",1649,61,3.7,1588,35.41,47053967400
1475,"Census Tract 9801, Gibson County, Tennessee",8,0,0.0,8,21.5,47053980100
1476,"Census Tract 9201, Giles County, Tennessee",1416,62,4.38,1354,40.4,47055920100
1477,"Census Tract 9202, Giles County, Tennessee",1712,24,1.4,1688,29.92,47055920200
1478,"Census Tract 9203, Giles County, Tennessee",2557,64,2.5,2493,32.3,47055920300
1479,"Census Tract 9204, Giles County, Tennessee",1310,22,1.68,1288,26.2,47055920400
1480,"Census Tract 9205, Giles County, Tennessee",2005,34,1.7,1971,28.79,47055920500
1481,"Census Tract 9206, Giles County, Tennessee",1144,15,1.31,1129,33.96,47055920600
1482,"Census Tract 9207, Giles County, Tennessee",703,19,2.7,684,42.45,47055920700
1483,"Census Tract 101.03, Hamilton County, Tennessee",1968,10,0.51,1958,32.11,47065010103
1484,"Census Tract 9208, Giles County, Tennessee",1163,11,0.95,1152,37.13,47055920800
1485,"Census Tract 5004.01, Grainger County, Tennessee",887,0,0.0,887,33.41,47057500401
1486,"Census Tract 5004.02, Grainger County, Tennessee",1765,179,10.14,1586,41.95,47057500402
1487,"Census Tract 403.08, Rutherford County, Tennessee",3407,109,3.2,3298,40.16,47149040308
1488,"Census Tract 405.01, Rutherford County, Tennessee",4352,342,7.86,4010,42.64,47149040501
1489,"Census Tract 405.02, Rutherford County, Tennessee",3769,227,6.02,3542,34.33,47149040502
1490,"Census Tract 407.01, Rutherford County, Tennessee",5942,271,4.56,5671,35.24,47149040701
1491,"Census Tract 407.02, Rutherford County, Tennessee",3214,187,5.82,3027,37.96,47149040702
1492,"Census Tract 408.05, Rutherford County, Tennessee",4867,234,4.81,4633,33.26,47149040805
1493,"Census Tract 408.06, Rutherford County, Tennessee",3758,158,4.2,3600,40.65,47149040806
1494,"Census Tract 408.07, Rutherford County, Tennessee",3267,142,4.35,3125,40.81,47149040807
1495,"Census Tract 408.08, Rutherford County, Tennessee",4444,408,9.18,4036,34.91,47149040808
1496,"Census Tract 408.09, Rutherford County, Tennessee",2218,119,5.37,2099,37.79,47149040809
