,TractCode,NAME_2015,Workers - Commute Method_2015,Work From Home_2015,Proportion Work From Home_2015,Workers - Commute Length_2015,Median Commute Length_2015,NAME_2017,Workers - Commute Method_2017,Work From Home_2017,Proportion Work From Home_2017,Workers - Commute Length_2017,Median Commute Length_2017,NAME_2019,Workers - Commute Method_2019,Work From Home_2019,Proportion Work From Home_2019,Workers - Commute Length_2019,Median Commute Length_2019
0,47165021002,"Census Tract 210.02, Sumner County, Tennessee",3482,210,6.03,3272,32.88,"Census Tract 210.02, Sumner County, Tennessee",3834,272,7.09,3562,29.7,"Census Tract 210.02, Sumner County, Tennessee",3679,288,7.83,3391,33.34
1,47165020901,"Census Tract 209.01, Sumner County, Tennessee",826,68,8.23,758,34.79,"Census Tract 209.01, Sumner County, Tennessee",731,104,14.23,627,37.7,"Census Tract 209.01, Sumner County, Tennessee",561,60,10.7,501,47.01
2,47165020300,"Census Tract 203, Sumner County, Tennessee",2098,220,10.49,1878,32.18,"Census Tract 203, Sumner County, Tennessee",2078,68,3.27,2010,29.81,"Census Tract 203, Sumner County, Tennessee",2485,136,5.47,2349,27.53
3,47165020902,"Census Tract 209.02, Sumner County, Tennessee",3240,35,1.08,3205,30.02,"Census Tract 209.02, Sumner County, Tennessee",3258,119,3.65,3139,28.88,"Census Tract 209.02, Sumner County, Tennessee",3487,77,2.21,3410,33.09
4,47165020800,"Census Tract 208, Sumner County, Tennessee",2660,42,1.58,2618,27.86,"Census Tract 208, Sumner County, Tennessee",2877,108,3.75,2769,26.3,"Census Tract 208, Sumner County, Tennessee",3042,135,4.44,2907,26.61
5,47165021203,"Census Tract 212.03, Sumner County, Tennessee",2924,254,8.69,2670,38.19,"Census Tract 212.03, Sumner County, Tennessee",3532,300,8.49,3232,37.17,"Census Tract 212.03, Sumner County, Tennessee",3933,309,7.86,3624,38.53
6,47105060302,"Census Tract 603.02, Loudon County, Tennessee",2949,125,4.24,2824,29.25,"Census Tract 603.02, Loudon County, Tennessee",3217,266,8.27,2951,27.13,"Census Tract 603.02, Loudon County, Tennessee",3293,328,9.96,2965,26.45
7,47105060202,"Census Tract 602.02, Loudon County, Tennessee",2918,43,1.47,2875,29.36,"Census Tract 602.02, Loudon County, Tennessee",3087,46,1.49,3041,24.59,"Census Tract 602.02, Loudon County, Tennessee",3181,39,1.23,3142,24.72
8,47105060301,"Census Tract 603.01, Loudon County, Tennessee",1495,39,2.61,1456,24.43,"Census Tract 603.01, Loudon County, Tennessee",1901,80,4.21,1821,26.05,"Census Tract 603.01, Loudon County, Tennessee",2251,160,7.11,2091,23.49
9,47179060400,"Census Tract 604, Washington County, Tennessee",2921,85,2.91,2836,18.79,"Census Tract 604, Washington County, Tennessee",2900,113,3.9,2787,22.78,"Census Tract 604, Washington County, Tennessee",2885,67,2.32,2818,21.75
10,47157001200,"Census Tract 12, Shelby County, Tennessee",1603,29,1.81,1574,26.97,"Census Tract 12, Shelby County, Tennessee",1850,26,1.41,1824,22.1,"Census Tract 12, Shelby County, Tennessee",2037,28,1.37,2009,22.07
11,47157001300,"Census Tract 13, Shelby County, Tennessee",1072,0,0.0,1072,27.64,"Census Tract 13, Shelby County, Tennessee",1138,52,4.57,1086,27.23,"Census Tract 13, Shelby County, Tennessee",973,58,5.96,915,29.46
12,47157001400,"Census Tract 14, Shelby County, Tennessee",624,0,0.0,624,31.35,"Census Tract 14, Shelby County, Tennessee",746,5,0.67,741,31.3,"Census Tract 14, Shelby County, Tennessee",718,6,0.84,712,32.09
13,47157001500,"Census Tract 15, Shelby County, Tennessee",469,32,6.82,437,31.37,"Census Tract 15, Shelby County, Tennessee",532,30,5.64,502,28.09,"Census Tract 15, Shelby County, Tennessee",660,5,0.76,655,23.85
14,47157001700,"Census Tract 17, Shelby County, Tennessee",2199,39,1.77,2160,23.38,"Census Tract 17, Shelby County, Tennessee",2207,56,2.54,2151,24.05,"Census Tract 17, Shelby County, Tennessee",2258,60,2.66,2198,22.13
15,47157001900,"Census Tract 19, Shelby County, Tennessee",416,0,0.0,416,29.74,"Census Tract 19, Shelby County, Tennessee",446,0,0.0,446,32.23,"Census Tract 19, Shelby County, Tennessee",534,0,0.0,534,22.01
16,47157002000,"Census Tract 20, Shelby County, Tennessee",544,34,6.25,510,22.08,"Census Tract 20, Shelby County, Tennessee",551,57,10.34,494,21.22,"Census Tract 20, Shelby County, Tennessee",587,40,6.81,547,24.87
17,47157002100,"Census Tract 21, Shelby County, Tennessee",534,5,0.94,529,25.96,"Census Tract 21, Shelby County, Tennessee",475,16,3.37,459,27.33,"Census Tract 21, Shelby County, Tennessee",527,51,9.68,476,30.66
18,47157002400,"Census Tract 24, Shelby County, Tennessee",955,0,0.0,955,21.29,"Census Tract 24, Shelby County, Tennessee",865,0,0.0,865,23.8,"Census Tract 24, Shelby County, Tennessee",830,0,0.0,830,23.84
19,47157002500,"Census Tract 25, Shelby County, Tennessee",1442,83,5.76,1359,28.05,"Census Tract 25, Shelby County, Tennessee",1528,54,3.53,1474,21.2,"Census Tract 25, Shelby County, Tennessee",1554,95,6.11,1459,22.08
20,47179061800,"Census Tract 618, Washington County, Tennessee",2595,33,1.27,2562,31.64,"Census Tract 618, Washington County, Tennessee",2867,41,1.43,2826,33.12,"Census Tract 618, Washington County, Tennessee",2969,76,2.56,2893,32.0
21,47179061300,"Census Tract 613, Washington County, Tennessee",3909,118,3.02,3791,23.76,"Census Tract 613, Washington County, Tennessee",4070,76,1.87,3994,21.32,"Census Tract 613, Washington County, Tennessee",4067,84,2.07,3983,22.14
22,47179061100,"Census Tract 611, Washington County, Tennessee",1850,116,6.27,1734,22.11,"Census Tract 611, Washington County, Tennessee",1917,56,2.92,1861,22.04,"Census Tract 611, Washington County, Tennessee",1868,137,7.33,1731,20.65
23,47179060600,"Census Tract 606, Washington County, Tennessee",3497,130,3.72,3367,23.54,"Census Tract 606, Washington County, Tennessee",3433,168,4.89,3265,22.32,"Census Tract 606, Washington County, Tennessee",3297,150,4.55,3147,23.61
24,47179061200,"Census Tract 612, Washington County, Tennessee",1469,38,2.59,1431,21.93,"Census Tract 612, Washington County, Tennessee",1739,28,1.61,1711,21.64,"Census Tract 612, Washington County, Tennessee",1837,54,2.94,1783,20.44
25,47179060900,"Census Tract 609, Washington County, Tennessee",2178,4,0.18,2174,18.69,"Census Tract 609, Washington County, Tennessee",2104,2,0.1,2102,19.13,"Census Tract 609, Washington County, Tennessee",2160,108,5.0,2052,20.43
26,47179061500,"Census Tract 615, Washington County, Tennessee",3489,129,3.7,3360,25.97,"Census Tract 615, Washington County, Tennessee",3590,126,3.51,3464,24.7,"Census Tract 615, Washington County, Tennessee",3397,159,4.68,3238,26.15
27,47037010106,"Census Tract 101.06, Davidson County, Tennessee",1406,19,1.35,1387,24.21,"Census Tract 101.06, Davidson County, Tennessee",1634,19,1.16,1615,25.67,"Census Tract 101.06, Davidson County, Tennessee",1669,52,3.12,1617,30.85
28,47179060100,"Census Tract 601, Washington County, Tennessee",1582,74,4.68,1508,16.75,"Census Tract 601, Washington County, Tennessee",1380,49,3.55,1331,17.73,"Census Tract 601, Washington County, Tennessee",1405,57,4.06,1348,21.43
29,47157002600,"Census Tract 26, Shelby County, Tennessee",1541,130,8.44,1411,23.13,"Census Tract 26, Shelby County, Tennessee",1569,88,5.61,1481,20.22,"Census Tract 26, Shelby County, Tennessee",1617,49,3.03,1568,18.01
30,47157002700,"Census Tract 27, Shelby County, Tennessee",936,36,3.85,900,22.06,"Census Tract 27, Shelby County, Tennessee",1022,41,4.01,981,24.48,"Census Tract 27, Shelby County, Tennessee",1147,54,4.71,1093,24.75
31,47157002800,"Census Tract 28, Shelby County, Tennessee",1134,0,0.0,1134,29.46,"Census Tract 28, Shelby County, Tennessee",1046,0,0.0,1046,27.62,"Census Tract 28, Shelby County, Tennessee",908,7,0.77,901,25.05
32,47157002900,"Census Tract 29, Shelby County, Tennessee",2598,121,4.66,2477,22.59,"Census Tract 29, Shelby County, Tennessee",2650,130,4.91,2520,23.39,"Census Tract 29, Shelby County, Tennessee",2606,191,7.33,2415,22.79
33,47105060201,"Census Tract 602.01, Loudon County, Tennessee",1709,35,2.05,1674,37.92,"Census Tract 602.01, Loudon County, Tennessee",1795,70,3.9,1725,32.12,"Census Tract 602.01, Loudon County, Tennessee",1860,128,6.88,1732,30.53
34,47105060501,"Census Tract 605.01, Loudon County, Tennessee",2148,232,10.8,1916,37.97,"Census Tract 605.01, Loudon County, Tennessee",1582,127,8.03,1455,35.35,"Census Tract 605.01, Loudon County, Tennessee",1441,134,9.3,1307,31.61
35,47105060502,"Census Tract 605.02, Loudon County, Tennessee",871,12,1.38,859,24.78,"Census Tract 605.02, Loudon County, Tennessee",859,19,2.21,840,28.78,"Census Tract 605.02, Loudon County, Tennessee",940,23,2.45,917,32.57
36,47037010103,"Census Tract 101.03, Davidson County, Tennessee",1210,50,4.13,1160,37.2,"Census Tract 101.03, Davidson County, Tennessee",1176,33,2.81,1143,39.04,"Census Tract 101.03, Davidson County, Tennessee",1169,42,3.59,1127,37.84
37,47037010202,"Census Tract 102.02, Davidson County, Tennessee",1787,160,8.95,1627,36.26,"Census Tract 102.02, Davidson County, Tennessee",1788,202,11.3,1586,36.73,"Census Tract 102.02, Davidson County, Tennessee",1948,234,12.01,1714,35.03
38,47037010104,"Census Tract 101.04, Davidson County, Tennessee",1502,88,5.86,1414,32.59,"Census Tract 101.04, Davidson County, Tennessee",1362,92,6.75,1270,34.75,"Census Tract 101.04, Davidson County, Tennessee",1527,107,7.01,1420,33.01
39,47121960200,"Census Tract 9602, Meigs County, Tennessee",1410,29,2.06,1381,32.41,"Census Tract 9602, Meigs County, Tennessee",1782,17,0.95,1765,36.1,"Census Tract 9602, Meigs County, Tennessee",1747,55,3.15,1692,35.7
40,47035970200,"Census Tract 9702, Cumberland County, Tennessee",2583,139,5.38,2444,27.07,"Census Tract 9702, Cumberland County, Tennessee",2907,129,4.44,2778,30.24,"Census Tract 9702, Cumberland County, Tennessee",2997,137,4.57,2860,32.27
41,47035970800,"Census Tract 9708, Cumberland County, Tennessee",1539,26,1.69,1513,33.5,"Census Tract 9708, Cumberland County, Tennessee",1443,19,1.32,1424,33.64,"Census Tract 9708, Cumberland County, Tennessee",1344,22,1.64,1322,33.33
42,47035970400,"Census Tract 9704, Cumberland County, Tennessee",1956,16,0.82,1940,21.32,"Census Tract 9704, Cumberland County, Tennessee",2095,33,1.58,2062,19.11,"Census Tract 9704, Cumberland County, Tennessee",2275,128,5.63,2147,18.49
43,47055920300,"Census Tract 9203, Giles County, Tennessee",2346,45,1.92,2301,27.72,"Census Tract 9203, Giles County, Tennessee",2671,71,2.66,2600,30.42,"Census Tract 9203, Giles County, Tennessee",2601,129,4.96,2472,32.32
44,47121960100,"Census Tract 9601, Meigs County, Tennessee",815,11,1.35,804,35.64,"Census Tract 9601, Meigs County, Tennessee",901,8,0.89,893,35.38,"Census Tract 9601, Meigs County, Tennessee",997,12,1.2,985,42.22
45,47121960300,"Census Tract 9603, Meigs County, Tennessee",1558,29,1.86,1529,42.2,"Census Tract 9603, Meigs County, Tennessee",1509,36,2.39,1473,41.44,"Census Tract 9603, Meigs County, Tennessee",1661,44,2.65,1617,36.61
46,47157003000,"Census Tract 30, Shelby County, Tennessee",1394,47,3.37,1347,20.59,"Census Tract 30, Shelby County, Tennessee",1288,47,3.65,1241,23.08,"Census Tract 30, Shelby County, Tennessee",1182,12,1.02,1170,23.03
47,47135930100,"Census Tract 9301, Perry County, Tennessee",1050,81,7.71,969,36.96,"Census Tract 9301, Perry County, Tennessee",1001,65,6.49,936,39.32,"Census Tract 9301, Perry County, Tennessee",1055,74,7.01,981,32.71
48,47113000900,"Census Tract 9, Madison County, Tennessee",586,3,0.51,583,18.13,"Census Tract 9, Madison County, Tennessee",669,0,0.0,669,26.41,"Census Tract 9, Madison County, Tennessee",707,67,9.48,640,22.02
49,47065001100,"Census Tract 11, Hamilton County, Tennessee",957,31,3.24,926,19.84,"Census Tract 11, Hamilton County, Tennessee",814,41,5.04,773,19.66,"Census Tract 11, Hamilton County, Tennessee",824,51,6.19,773,25.84
50,47155080300,"Census Tract 803, Sevier County, Tennessee",2647,161,6.08,2486,31.73,"Census Tract 803, Sevier County, Tennessee",2622,140,5.34,2482,29.94,"Census Tract 803, Sevier County, Tennessee",2827,89,3.15,2738,33.99
51,47155080500,"Census Tract 805, Sevier County, Tennessee",2118,85,4.01,2033,25.13,"Census Tract 805, Sevier County, Tennessee",2541,120,4.72,2421,24.64,"Census Tract 805, Sevier County, Tennessee",2645,139,5.26,2506,26.8
52,47155080400,"Census Tract 804, Sevier County, Tennessee",3649,77,2.11,3572,32.92,"Census Tract 804, Sevier County, Tennessee",3506,63,1.8,3443,31.04,"Census Tract 804, Sevier County, Tennessee",3425,120,3.5,3305,33.07
53,47155081000,"Census Tract 810, Sevier County, Tennessee",2921,210,7.19,2711,24.93,"Census Tract 810, Sevier County, Tennessee",3204,232,7.24,2972,21.47,"Census Tract 810, Sevier County, Tennessee",3146,99,3.15,3047,22.28
54,47055920400,"Census Tract 9204, Giles County, Tennessee",1059,5,0.47,1054,25.76,"Census Tract 9204, Giles County, Tennessee",1224,14,1.14,1210,27.54,"Census Tract 9204, Giles County, Tennessee",1286,20,1.56,1266,30.8
55,47055920500,"Census Tract 9205, Giles County, Tennessee",1930,47,2.44,1883,29.39,"Census Tract 9205, Giles County, Tennessee",1855,44,2.37,1811,25.85,"Census Tract 9205, Giles County, Tennessee",1931,52,2.69,1879,28.73
56,47055920600,"Census Tract 9206, Giles County, Tennessee",1115,20,1.79,1095,37.6,"Census Tract 9206, Giles County, Tennessee",1160,12,1.03,1148,32.22,"Census Tract 9206, Giles County, Tennessee",1257,18,1.43,1239,34.33
57,47055920200,"Census Tract 9202, Giles County, Tennessee",1771,73,4.12,1698,27.15,"Census Tract 9202, Giles County, Tennessee",1746,74,4.24,1672,28.15,"Census Tract 9202, Giles County, Tennessee",1973,99,5.02,1874,29.18
58,47055920800,"Census Tract 9208, Giles County, Tennessee",1147,13,1.13,1134,34.06,"Census Tract 9208, Giles County, Tennessee",1135,10,0.88,1125,37.46,"Census Tract 9208, Giles County, Tennessee",1254,13,1.04,1241,36.53
59,47055920700,"Census Tract 9207, Giles County, Tennessee",723,6,0.83,717,35.91,"Census Tract 9207, Giles County, Tennessee",742,28,3.77,714,42.77,"Census Tract 9207, Giles County, Tennessee",629,23,3.66,606,41.32
60,47055920100,"Census Tract 9201, Giles County, Tennessee",1405,39,2.78,1366,40.23,"Census Tract 9201, Giles County, Tennessee",1462,69,4.72,1393,39.94,"Census Tract 9201, Giles County, Tennessee",1475,77,5.22,1398,41.52
61,47029920400,"Census Tract 9204, Cocke County, Tennessee",473,14,2.96,459,55.33,"Census Tract 9204, Cocke County, Tennessee",559,13,2.33,546,59.33,"Census Tract 9204, Cocke County, Tennessee",619,15,2.42,604,54.91
62,47157001100,"Census Tract 11, Shelby County, Tennessee",1393,0,0.0,1393,27.07,"Census Tract 11, Shelby County, Tennessee",1186,0,0.0,1186,26.1,"Census Tract 11, Shelby County, Tennessee",1212,24,1.98,1188,31.8
63,47037013300,"Census Tract 133, Davidson County, Tennessee",2211,27,1.22,2184,24.77,"Census Tract 133, Davidson County, Tennessee",2238,50,2.23,2188,24.56,"Census Tract 133, Davidson County, Tennessee",2698,172,6.38,2526,24.92
64,47037018102,"Census Tract 181.02, Davidson County, Tennessee",1779,129,7.25,1650,27.1,"Census Tract 181.02, Davidson County, Tennessee",1883,182,9.67,1701,27.78,"Census Tract 181.02, Davidson County, Tennessee",1752,129,7.36,1623,24.06
65,47029920100,"Census Tract 9201, Cocke County, Tennessee",1418,11,0.78,1407,32.53,"Census Tract 9201, Cocke County, Tennessee",1434,51,3.56,1383,33.02,"Census Tract 9201, Cocke County, Tennessee",1666,37,2.22,1629,35.7
66,47029920502,"Census Tract 9205.02, Cocke County, Tennessee",2664,0,0.0,2664,37.28,"Census Tract 9205.02, Cocke County, Tennessee",2749,21,0.76,2728,38.09,"Census Tract 9205.02, Cocke County, Tennessee",2667,94,3.52,2573,39.77
67,47029920200,"Census Tract 9202, Cocke County, Tennessee",2134,38,1.78,2096,23.03,"Census Tract 9202, Cocke County, Tennessee",2343,31,1.32,2312,22.56,"Census Tract 9202, Cocke County, Tennessee",2173,0,0.0,2173,20.92
68,47029920600,"Census Tract 9206, Cocke County, Tennessee",1708,56,3.28,1652,25.99,"Census Tract 9206, Cocke County, Tennessee",1649,35,2.12,1614,25.85,"Census Tract 9206, Cocke County, Tennessee",1416,28,1.98,1388,33.06
69,47029920300,"Census Tract 9203, Cocke County, Tennessee",1542,60,3.89,1482,36.64,"Census Tract 9203, Cocke County, Tennessee",1635,74,4.53,1561,37.75,"Census Tract 9203, Cocke County, Tennessee",1770,27,1.53,1743,34.01
70,47029920501,"Census Tract 9205.01, Cocke County, Tennessee",2147,0,0.0,2147,31.41,"Census Tract 9205.01, Cocke County, Tennessee",2098,21,1.0,2077,34.91,"Census Tract 9205.01, Cocke County, Tennessee",1822,11,0.6,1811,28.32
71,47065011324,"Census Tract 113.24, Hamilton County, Tennessee",2171,130,5.99,2041,30.74,"Census Tract 113.24, Hamilton County, Tennessee",2168,207,9.55,1961,30.66,"Census Tract 113.24, Hamilton County, Tennessee",2198,293,13.33,1905,32.18
72,47019070400,"Census Tract 704, Carter County, Tennessee",708,10,1.41,698,25.65,"Census Tract 704, Carter County, Tennessee",782,14,1.79,768,28.11,"Census Tract 704, Carter County, Tennessee",719,6,0.83,713,30.34
73,47019070700,"Census Tract 707, Carter County, Tennessee",1374,15,1.09,1359,30.14,"Census Tract 707, Carter County, Tennessee",1486,27,1.82,1459,32.09,"Census Tract 707, Carter County, Tennessee",1701,72,4.23,1629,28.73
74,47065001300,"Census Tract 13, Hamilton County, Tennessee",567,29,5.11,538,19.06,"Census Tract 13, Hamilton County, Tennessee",710,62,8.73,648,18.85,"Census Tract 13, Hamilton County, Tennessee",766,55,7.18,711,19.5
75,47031970801,"Census Tract 9708.01, Coffee County, Tennessee",1786,62,3.47,1724,22.95,"Census Tract 9708.01, Coffee County, Tennessee",1818,65,3.58,1753,23.35,"Census Tract 9708.01, Coffee County, Tennessee",1680,36,2.14,1644,27.27
76,47031980100,"Census Tract 9801, Coffee County, Tennessee",0,0,,0,0.0,"Census Tract 9801, Coffee County, Tennessee",0,0,,0,0.0,"Census Tract 9801, Coffee County, Tennessee",4,0,0.0,4,14.0
77,47065001400,"Census Tract 14, Hamilton County, Tennessee",865,33,3.82,832,17.34,"Census Tract 14, Hamilton County, Tennessee",832,31,3.73,801,18.89,"Census Tract 14, Hamilton County, Tennessee",952,62,6.51,890,21.32
78,47065003000,"Census Tract 30, Hamilton County, Tennessee",1195,28,2.34,1167,22.09,"Census Tract 30, Hamilton County, Tennessee",1146,25,2.18,1121,21.4,"Census Tract 30, Hamilton County, Tennessee",1070,35,3.27,1035,21.47
79,47065003400,"Census Tract 34, Hamilton County, Tennessee",2211,68,3.08,2143,20.33,"Census Tract 34, Hamilton County, Tennessee",2209,69,3.12,2140,21.74,"Census Tract 34, Hamilton County, Tennessee",2113,21,0.99,2092,23.82
80,47065010412,"Census Tract 104.12, Hamilton County, Tennessee",2622,46,1.75,2576,29.28,"Census Tract 104.12, Hamilton County, Tennessee",2502,87,3.48,2415,29.41,"Census Tract 104.12, Hamilton County, Tennessee",2527,89,3.52,2438,32.21
81,47065010433,"Census Tract 104.33, Hamilton County, Tennessee",1948,52,2.67,1896,22.85,"Census Tract 104.33, Hamilton County, Tennessee",1993,25,1.25,1968,24.59,"Census Tract 104.33, Hamilton County, Tennessee",2426,69,2.84,2357,22.14
82,47065010502,"Census Tract 105.02, Hamilton County, Tennessee",1737,60,3.45,1677,26.06,"Census Tract 105.02, Hamilton County, Tennessee",1645,60,3.65,1585,25.07,"Census Tract 105.02, Hamilton County, Tennessee",1612,107,6.64,1505,21.78
83,47065010307,"Census Tract 103.07, Hamilton County, Tennessee",2330,71,3.05,2259,27.88,"Census Tract 103.07, Hamilton County, Tennessee",2254,88,3.9,2166,28.73,"Census Tract 103.07, Hamilton County, Tennessee",2382,98,4.11,2284,30.25
84,47065012200,"Census Tract 122, Hamilton County, Tennessee",667,4,0.6,663,25.26,"Census Tract 122, Hamilton County, Tennessee",609,0,0.0,609,22.87,"Census Tract 122, Hamilton County, Tennessee",711,52,7.31,659,23.1
85,47065011445,"Census Tract 114.45, Hamilton County, Tennessee",2040,113,5.54,1927,21.11,"Census Tract 114.45, Hamilton County, Tennessee",2016,176,8.73,1840,22.75,"Census Tract 114.45, Hamilton County, Tennessee",1901,117,6.15,1784,20.81
86,47065010306,"Census Tract 103.06, Hamilton County, Tennessee",1701,65,3.82,1636,28.66,"Census Tract 103.06, Hamilton County, Tennessee",1815,108,5.95,1707,25.86,"Census Tract 103.06, Hamilton County, Tennessee",1694,138,8.15,1556,27.15
87,47065011446,"Census Tract 114.46, Hamilton County, Tennessee",1701,48,2.82,1653,20.9,"Census Tract 114.46, Hamilton County, Tennessee",2122,74,3.49,2048,21.19,"Census Tract 114.46, Hamilton County, Tennessee",2516,86,3.42,2430,21.09
88,47065011204,"Census Tract 112.04, Hamilton County, Tennessee",2816,129,4.58,2687,25.43,"Census Tract 112.04, Hamilton County, Tennessee",2980,242,8.12,2738,26.64,"Census Tract 112.04, Hamilton County, Tennessee",2660,235,8.83,2425,29.81
89,47065012300,"Census Tract 123, Hamilton County, Tennessee",1818,18,0.99,1800,27.17,"Census Tract 123, Hamilton County, Tennessee",1986,9,0.45,1977,27.96,"Census Tract 123, Hamilton County, Tennessee",1859,73,3.93,1786,23.73
90,47065002400,"Census Tract 24, Hamilton County, Tennessee",1510,76,5.03,1434,22.3,"Census Tract 24, Hamilton County, Tennessee",1640,112,6.83,1528,24.28,"Census Tract 24, Hamilton County, Tennessee",1584,49,3.09,1535,28.55
91,47065002800,"Census Tract 28, Hamilton County, Tennessee",1885,101,5.36,1784,24.41,"Census Tract 28, Hamilton County, Tennessee",1954,100,5.12,1854,20.59,"Census Tract 28, Hamilton County, Tennessee",1930,160,8.29,1770,19.74
92,47165021104,"Census Tract 211.04, Sumner County, Tennessee",1007,30,2.98,977,30.59,"Census Tract 211.04, Sumner County, Tennessee",1113,38,3.41,1075,31.54,"Census Tract 211.04, Sumner County, Tennessee",1054,39,3.7,1015,34.85
93,47165021205,"Census Tract 212.05, Sumner County, Tennessee",1187,56,4.72,1131,35.7,"Census Tract 212.05, Sumner County, Tennessee",1299,59,4.54,1240,36.6,"Census Tract 212.05, Sumner County, Tennessee",1292,62,4.8,1230,33.3
94,47165021009,"Census Tract 210.09, Sumner County, Tennessee",2564,96,3.74,2468,29.97,"Census Tract 210.09, Sumner County, Tennessee",2821,53,1.88,2768,27.45,"Census Tract 210.09, Sumner County, Tennessee",2723,50,1.84,2673,27.51
95,47165020501,"Census Tract 205.01, Sumner County, Tennessee",2379,376,15.8,2003,30.78,"Census Tract 205.01, Sumner County, Tennessee",2540,247,9.72,2293,35.83,"Census Tract 205.01, Sumner County, Tennessee",3002,287,9.56,2715,41.49
96,47187050205,"Census Tract 502.05, Williamson County, Tennessee",1807,143,7.91,1664,24.54,"Census Tract 502.05, Williamson County, Tennessee",1712,147,8.59,1565,27.3,"Census Tract 502.05, Williamson County, Tennessee",1613,121,7.5,1492,27.44
97,47037010602,"Census Tract 106.02, Davidson County, Tennessee",1780,0,0.0,1780,39.16,"Census Tract 106.02, Davidson County, Tennessee",1971,114,5.78,1857,42.59,"Census Tract 106.02, Davidson County, Tennessee",2076,137,6.6,1939,38.97
98,47037013602,"Census Tract 136.02, Davidson County, Tennessee",594,137,23.06,457,21.66,"Census Tract 136.02, Davidson County, Tennessee",675,60,8.89,615,20.24,"Census Tract 136.02, Davidson County, Tennessee",656,27,4.12,629,18.65
99,47065002900,"Census Tract 29, Hamilton County, Tennessee",1271,36,2.83,1235,22.95,"Census Tract 29, Hamilton County, Tennessee",1376,52,3.78,1324,21.03,"Census Tract 29, Hamilton County, Tennessee",1401,16,1.14,1385,20.8
100,47065010431,"Census Tract 104.31, Hamilton County, Tennessee",3361,164,4.88,3197,26.68,"Census Tract 104.31, Hamilton County, Tennessee",3255,283,8.69,2972,27.95,"Census Tract 104.31, Hamilton County, Tennessee",3424,264,7.71,3160,26.08
101,47065010101,"Census Tract 101.01, Hamilton County, Tennessee",2638,66,2.5,2572,31.98,"Census Tract 101.01, Hamilton County, Tennessee",2879,86,2.99,2793,30.2,"Census Tract 101.01, Hamilton County, Tennessee",3173,95,2.99,3078,28.05
102,47065003300,"Census Tract 33, Hamilton County, Tennessee",2956,176,5.95,2780,28.12,"Census Tract 33, Hamilton County, Tennessee",2649,139,5.25,2510,25.39,"Census Tract 33, Hamilton County, Tennessee",2801,164,5.86,2637,24.23
103,47065001200,"Census Tract 12, Hamilton County, Tennessee",932,0,0.0,932,22.17,"Census Tract 12, Hamilton County, Tennessee",1039,37,3.56,1002,21.05,"Census Tract 12, Hamilton County, Tennessee",1060,57,5.38,1003,20.24
104,47065010501,"Census Tract 105.01, Hamilton County, Tennessee",3044,196,6.44,2848,26.79,"Census Tract 105.01, Hamilton County, Tennessee",3045,179,5.88,2866,24.66,"Census Tract 105.01, Hamilton County, Tennessee",3299,103,3.12,3196,21.28
105,47065003200,"Census Tract 32, Hamilton County, Tennessee",1358,26,1.91,1332,18.98,"Census Tract 32, Hamilton County, Tennessee",1363,20,1.47,1343,19.31,"Census Tract 32, Hamilton County, Tennessee",1080,51,4.72,1029,19.34
106,47065011311,"Census Tract 113.11, Hamilton County, Tennessee",3144,102,3.24,3042,28.03,"Census Tract 113.11, Hamilton County, Tennessee",3571,313,8.77,3258,26.73,"Census Tract 113.11, Hamilton County, Tennessee",4456,284,6.37,4172,24.32
107,47065012100,"Census Tract 121, Hamilton County, Tennessee",2430,71,2.92,2359,20.85,"Census Tract 121, Hamilton County, Tennessee",2765,140,5.06,2625,20.96,"Census Tract 121, Hamilton County, Tennessee",3130,220,7.03,2910,21.71
108,47065002000,"Census Tract 20, Hamilton County, Tennessee",702,42,5.98,660,20.52,"Census Tract 20, Hamilton County, Tennessee",764,35,4.58,729,20.3,"Census Tract 20, Hamilton County, Tennessee",920,80,8.7,840,20.43
109,47065010600,"Census Tract 106, Hamilton County, Tennessee",1349,51,3.78,1298,23.46,"Census Tract 106, Hamilton County, Tennessee",1282,64,4.99,1218,22.76,"Census Tract 106, Hamilton County, Tennessee",1627,54,3.32,1573,22.17
110,47065011442,"Census Tract 114.42, Hamilton County, Tennessee",1417,72,5.08,1345,22.06,"Census Tract 114.42, Hamilton County, Tennessee",1388,87,6.27,1301,22.01,"Census Tract 114.42, Hamilton County, Tennessee",1507,70,4.64,1437,21.91
111,47065000400,"Census Tract 4, Hamilton County, Tennessee",999,0,0.0,999,20.99,"Census Tract 4, Hamilton County, Tennessee",1271,9,0.71,1262,21.91,"Census Tract 4, Hamilton County, Tennessee",1218,9,0.74,1209,25.43
112,47065011800,"Census Tract 118, Hamilton County, Tennessee",3331,76,2.28,3255,20.93,"Census Tract 118, Hamilton County, Tennessee",3453,73,2.11,3380,21.69,"Census Tract 118, Hamilton County, Tennessee",3465,87,2.51,3378,20.48
113,47065011321,"Census Tract 113.21, Hamilton County, Tennessee",3496,138,3.95,3358,23.91,"Census Tract 113.21, Hamilton County, Tennessee",4083,158,3.87,3925,24.89,"Census Tract 113.21, Hamilton County, Tennessee",4019,203,5.05,3816,25.07
114,47001020300,"Census Tract 203, Anderson County, Tennessee",1880,88,4.68,1792,23.19,"Census Tract 203, Anderson County, Tennessee",1859,79,4.25,1780,25.3,"Census Tract 203, Anderson County, Tennessee",1722,61,3.54,1661,26.82
115,47065003100,"Census Tract 31, Hamilton County, Tennessee",634,35,5.52,599,16.28,"Census Tract 31, Hamilton County, Tennessee",755,70,9.27,685,18.16,"Census Tract 31, Hamilton County, Tennessee",946,84,8.88,862,16.81
116,47065000800,"Census Tract 8, Hamilton County, Tennessee",850,75,8.82,775,24.26,"Census Tract 8, Hamilton County, Tennessee",912,69,7.57,843,21.46,"Census Tract 8, Hamilton County, Tennessee",942,82,8.7,860,23.5
117,47135930200,"Census Tract 9302, Perry County, Tennessee",1620,70,4.32,1550,33.46,"Census Tract 9302, Perry County, Tennessee",1615,184,11.39,1431,33.03,"Census Tract 9302, Perry County, Tennessee",1673,183,10.94,1490,28.46
118,47187050304,"Census Tract 503.04, Williamson County, Tennessee",666,48,7.21,618,28.97,"Census Tract 503.04, Williamson County, Tennessee",874,101,11.56,773,29.77,"Census Tract 503.04, Williamson County, Tennessee",1106,150,13.56,956,28.23
119,47187050203,"Census Tract 502.03, Williamson County, Tennessee",2367,200,8.45,2167,25.19,"Census Tract 502.03, Williamson County, Tennessee",2425,116,4.78,2309,28.87,"Census Tract 502.03, Williamson County, Tennessee",2655,206,7.76,2449,30.84
120,47187050905,"Census Tract 509.05, Williamson County, Tennessee",3413,200,5.86,3213,25.26,"Census Tract 509.05, Williamson County, Tennessee",3726,157,4.21,3569,25.75,"Census Tract 509.05, Williamson County, Tennessee",3600,254,7.06,3346,29.29
121,47187050204,"Census Tract 502.04, Williamson County, Tennessee",2630,263,10.0,2367,31.99,"Census Tract 502.04, Williamson County, Tennessee",2533,244,9.63,2289,32.19,"Census Tract 502.04, Williamson County, Tennessee",2789,367,13.16,2422,32.52
122,47037019200,"Census Tract 192, Davidson County, Tennessee",2038,122,5.99,1916,21.1,"Census Tract 192, Davidson County, Tennessee",1955,303,15.5,1652,24.48,"Census Tract 192, Davidson County, Tennessee",2239,411,18.36,1828,23.55
123,47037019500,"Census Tract 195, Davidson County, Tennessee",3159,336,10.64,2823,21.02,"Census Tract 195, Davidson County, Tennessee",4153,429,10.33,3724,21.71,"Census Tract 195, Davidson County, Tennessee",5543,548,9.89,4995,20.14
124,47037019400,"Census Tract 194, Davidson County, Tennessee",2055,156,7.59,1899,25.42,"Census Tract 194, Davidson County, Tennessee",2821,359,12.73,2462,23.38,"Census Tract 194, Davidson County, Tennessee",4154,486,11.7,3668,23.75
125,47029920700,"Census Tract 9207, Cocke County, Tennessee",1527,17,1.11,1510,44.69,"Census Tract 9207, Cocke County, Tennessee",1577,89,5.64,1488,44.48,"Census Tract 9207, Cocke County, Tennessee",1668,108,6.47,1560,48.27
126,47187050206,"Census Tract 502.06, Williamson County, Tennessee",1326,114,8.6,1212,28.72,"Census Tract 502.06, Williamson County, Tennessee",1360,173,12.72,1187,31.4,"Census Tract 502.06, Williamson County, Tennessee",1438,213,14.81,1225,31.96
127,47037016700,"Census Tract 167, Davidson County, Tennessee",2895,156,5.39,2739,22.18,"Census Tract 167, Davidson County, Tennessee",2973,274,9.22,2699,20.59,"Census Tract 167, Davidson County, Tennessee",3205,237,7.39,2968,21.59
128,47037015612,"Census Tract 156.12, Davidson County, Tennessee",4134,175,4.23,3959,31.34,"Census Tract 156.12, Davidson County, Tennessee",4313,90,2.09,4223,33.4,"Census Tract 156.12, Davidson County, Tennessee",4411,80,1.81,4331,32.27
129,47037010105,"Census Tract 101.05, Davidson County, Tennessee",2058,28,1.36,2030,28.93,"Census Tract 101.05, Davidson County, Tennessee",1887,73,3.87,1814,29.24,"Census Tract 101.05, Davidson County, Tennessee",2162,154,7.12,2008,31.7
130,47037010303,"Census Tract 103.03, Davidson County, Tennessee",2682,72,2.68,2610,30.55,"Census Tract 103.03, Davidson County, Tennessee",2744,159,5.79,2585,32.14,"Census Tract 103.03, Davidson County, Tennessee",2647,125,4.72,2522,31.01
131,47001021201,"Census Tract 212.01, Anderson County, Tennessee",1920,25,1.3,1895,27.36,"Census Tract 212.01, Anderson County, Tennessee",2064,7,0.34,2057,25.87,"Census Tract 212.01, Anderson County, Tennessee",2061,18,0.87,2043,28.07
132,47001021302,"Census Tract 213.02, Anderson County, Tennessee",3274,235,7.18,3039,28.19,"Census Tract 213.02, Anderson County, Tennessee",3511,202,5.75,3309,29.7,"Census Tract 213.02, Anderson County, Tennessee",3083,136,4.41,2947,29.12
133,47001021202,"Census Tract 212.02, Anderson County, Tennessee",1857,0,0.0,1857,26.38,"Census Tract 212.02, Anderson County, Tennessee",2137,20,0.94,2117,26.07,"Census Tract 212.02, Anderson County, Tennessee",1964,21,1.07,1943,26.42
134,47001020901,"Census Tract 209.01, Anderson County, Tennessee",2516,69,2.74,2447,31.61,"Census Tract 209.01, Anderson County, Tennessee",2423,110,4.54,2313,33.79,"Census Tract 209.01, Anderson County, Tennessee",2813,155,5.51,2658,36.84
135,47001020902,"Census Tract 209.02, Anderson County, Tennessee",2704,14,0.52,2690,28.62,"Census Tract 209.02, Anderson County, Tennessee",2557,0,0.0,2557,30.21,"Census Tract 209.02, Anderson County, Tennessee",2582,30,1.16,2552,30.11
136,47001020700,"Census Tract 207, Anderson County, Tennessee",453,0,0.0,453,34.96,"Census Tract 207, Anderson County, Tennessee",495,8,1.62,487,37.31,"Census Tract 207, Anderson County, Tennessee",628,13,2.07,615,36.7
137,47001020100,"Census Tract 201, Anderson County, Tennessee",1202,0,0.0,1202,22.86,"Census Tract 201, Anderson County, Tennessee",1463,23,1.57,1440,25.27,"Census Tract 201, Anderson County, Tennessee",1518,119,7.84,1399,25.43
138,47001020400,"Census Tract 204, Anderson County, Tennessee",1615,94,5.82,1521,26.55,"Census Tract 204, Anderson County, Tennessee",1657,91,5.49,1566,26.85,"Census Tract 204, Anderson County, Tennessee",1757,57,3.24,1700,26.7
139,47001020500,"Census Tract 205, Anderson County, Tennessee",1680,8,0.48,1672,24.9,"Census Tract 205, Anderson County, Tennessee",1503,13,0.86,1490,26.29,"Census Tract 205, Anderson County, Tennessee",1471,10,0.68,1461,29.26
140,47001021000,"Census Tract 210, Anderson County, Tennessee",2318,37,1.6,2281,28.3,"Census Tract 210, Anderson County, Tennessee",2448,42,1.72,2406,28.34,"Census Tract 210, Anderson County, Tennessee",2453,54,2.2,2399,32.86
141,47001021301,"Census Tract 213.01, Anderson County, Tennessee",1345,38,2.83,1307,26.6,"Census Tract 213.01, Anderson County, Tennessee",1351,40,2.96,1311,29.53,"Census Tract 213.01, Anderson County, Tennessee",1508,83,5.5,1425,31.55
142,47001020800,"Census Tract 208, Anderson County, Tennessee",1524,30,1.97,1494,30.79,"Census Tract 208, Anderson County, Tennessee",1491,31,2.08,1460,31.26,"Census Tract 208, Anderson County, Tennessee",1766,33,1.87,1733,30.73
143,47001021100,"Census Tract 211, Anderson County, Tennessee",1660,102,6.14,1558,26.17,"Census Tract 211, Anderson County, Tennessee",1617,69,4.27,1548,25.0,"Census Tract 211, Anderson County, Tennessee",1742,72,4.13,1670,25.41
144,47093007100,"Census Tract 71, Knox County, Tennessee",2090,122,5.84,1968,21.92,"Census Tract 71, Knox County, Tennessee",1865,92,4.93,1773,21.55,"Census Tract 71, Knox County, Tennessee",1890,71,3.76,1819,21.09
145,47093006207,"Census Tract 62.07, Knox County, Tennessee",1766,35,1.98,1731,26.33,"Census Tract 62.07, Knox County, Tennessee",1783,45,2.52,1738,26.22,"Census Tract 62.07, Knox County, Tennessee",1914,58,3.03,1856,26.95
146,47093005810,"Census Tract 58.10, Knox County, Tennessee",1706,108,6.33,1598,30.67,"Census Tract 58.10, Knox County, Tennessee",1658,139,8.38,1519,26.71,"Census Tract 58.10, Knox County, Tennessee",1677,164,9.78,1513,27.81
147,47093004612,"Census Tract 46.12, Knox County, Tennessee",1709,85,4.97,1624,23.62,"Census Tract 46.12, Knox County, Tennessee",1558,38,2.44,1520,23.07,"Census Tract 46.12, Knox County, Tennessee",1585,66,4.16,1519,27.22
148,47125980100,"Census Tract 9801, Montgomery County, Tennessee",276,16,5.8,260,10.02,"Census Tract 9801, Montgomery County, Tennessee",277,13,4.69,264,9.49,"Census Tract 9801, Montgomery County, Tennessee",289,0,0.0,289,10.26
149,47125101804,"Census Tract 1018.04, Montgomery County, Tennessee",3283,74,2.25,3209,33.2,"Census Tract 1018.04, Montgomery County, Tennessee",3368,68,2.02,3300,32.52,"Census Tract 1018.04, Montgomery County, Tennessee",3485,126,3.62,3359,29.46
150,47125101903,"Census Tract 1019.03, Montgomery County, Tennessee",4493,68,1.51,4425,26.11,"Census Tract 1019.03, Montgomery County, Tennessee",4981,44,0.88,4937,29.78,"Census Tract 1019.03, Montgomery County, Tennessee",5818,226,3.88,5592,27.0
151,47125101904,"Census Tract 1019.04, Montgomery County, Tennessee",1389,79,5.69,1310,30.35,"Census Tract 1019.04, Montgomery County, Tennessee",1620,98,6.05,1522,30.39,"Census Tract 1019.04, Montgomery County, Tennessee",2453,194,7.91,2259,30.91
152,47125101306,"Census Tract 1013.06, Montgomery County, Tennessee",2789,43,1.54,2746,25.69,"Census Tract 1013.06, Montgomery County, Tennessee",2591,38,1.47,2553,30.18,"Census Tract 1013.06, Montgomery County, Tennessee",2782,83,2.98,2699,34.24
153,47125101305,"Census Tract 1013.05, Montgomery County, Tennessee",1437,15,1.04,1422,31.39,"Census Tract 1013.05, Montgomery County, Tennessee",2006,86,4.29,1920,30.13,"Census Tract 1013.05, Montgomery County, Tennessee",2678,121,4.52,2557,29.86
154,47125102002,"Census Tract 1020.02, Montgomery County, Tennessee",3595,134,3.73,3461,32.46,"Census Tract 1020.02, Montgomery County, Tennessee",4018,206,5.13,3812,31.56,"Census Tract 1020.02, Montgomery County, Tennessee",4412,143,3.24,4269,31.53
155,47155080901,"Census Tract 809.01, Sevier County, Tennessee",1575,107,6.79,1468,29.85,"Census Tract 809.01, Sevier County, Tennessee",1788,131,7.33,1657,26.4,"Census Tract 809.01, Sevier County, Tennessee",1730,186,10.75,1544,23.31
156,47155080201,"Census Tract 802.01, Sevier County, Tennessee",3945,126,3.19,3819,37.51,"Census Tract 802.01, Sevier County, Tennessee",3790,142,3.75,3648,40.1,"Census Tract 802.01, Sevier County, Tennessee",4044,288,7.12,3756,39.87
157,47155080202,"Census Tract 802.02, Sevier County, Tennessee",2309,89,3.85,2220,33.93,"Census Tract 802.02, Sevier County, Tennessee",2728,202,7.4,2526,37.33,"Census Tract 802.02, Sevier County, Tennessee",2789,293,10.51,2496,42.44
158,47155080802,"Census Tract 808.02, Sevier County, Tennessee",3542,201,5.67,3341,22.82,"Census Tract 808.02, Sevier County, Tennessee",3526,169,4.79,3357,21.28,"Census Tract 808.02, Sevier County, Tennessee",3477,235,6.76,3242,23.37
159,47155080902,"Census Tract 809.02, Sevier County, Tennessee",2195,123,5.6,2072,40.64,"Census Tract 809.02, Sevier County, Tennessee",2282,85,3.72,2197,33.7,"Census Tract 809.02, Sevier County, Tennessee",2255,84,3.73,2171,28.81
160,47065011411,"Census Tract 114.11, Hamilton County, Tennessee",2049,58,2.83,1991,23.75,"Census Tract 114.11, Hamilton County, Tennessee",2042,39,1.91,2003,24.86,"Census Tract 114.11, Hamilton County, Tennessee",2057,72,3.5,1985,26.49
161,47017962300,"Census Tract 9623, Carroll County, Tennessee",1939,28,1.44,1911,34.85,"Census Tract 9623, Carroll County, Tennessee",1748,60,3.43,1688,31.59,"Census Tract 9623, Carroll County, Tennessee",1802,64,3.55,1738,37.74
162,47017962400,"Census Tract 9624, Carroll County, Tennessee",905,56,6.19,849,38.81,"Census Tract 9624, Carroll County, Tennessee",1064,48,4.51,1016,37.72,"Census Tract 9624, Carroll County, Tennessee",1082,57,5.27,1025,40.52
163,47017962500,"Census Tract 9625, Carroll County, Tennessee",857,9,1.05,848,30.44,"Census Tract 9625, Carroll County, Tennessee",738,9,1.22,729,33.46,"Census Tract 9625, Carroll County, Tennessee",851,15,1.76,836,33.56
164,47017962000,"Census Tract 9620, Carroll County, Tennessee",1587,70,4.41,1517,33.04,"Census Tract 9620, Carroll County, Tennessee",1506,32,2.12,1474,29.08,"Census Tract 9620, Carroll County, Tennessee",1521,100,6.57,1421,28.14
165,47017962100,"Census Tract 9621, Carroll County, Tennessee",2220,17,0.77,2203,26.15,"Census Tract 9621, Carroll County, Tennessee",2308,27,1.17,2281,24.38,"Census Tract 9621, Carroll County, Tennessee",2378,29,1.22,2349,29.77
166,47021070203,"Census Tract 702.03, Cheatham County, Tennessee",1578,0,0.0,1578,42.23,"Census Tract 702.03, Cheatham County, Tennessee",1734,26,1.5,1708,42.96,"Census Tract 702.03, Cheatham County, Tennessee",1594,43,2.7,1551,45.03
167,47021070103,"Census Tract 701.03, Cheatham County, Tennessee",1746,27,1.55,1719,32.85,"Census Tract 701.03, Cheatham County, Tennessee",1563,66,4.22,1497,31.76,"Census Tract 701.03, Cheatham County, Tennessee",1935,75,3.88,1860,40.37
168,47065010411,"Census Tract 104.11, Hamilton County, Tennessee",3512,172,4.9,3340,28.45,"Census Tract 104.11, Hamilton County, Tennessee",3206,247,7.7,2959,28.85,"Census Tract 104.11, Hamilton County, Tennessee",3774,132,3.5,3642,28.72
169,47065001800,"Census Tract 18, Hamilton County, Tennessee",1547,39,2.52,1508,21.32,"Census Tract 18, Hamilton County, Tennessee",1342,60,4.47,1282,22.72,"Census Tract 18, Hamilton County, Tennessee",1378,78,5.66,1300,22.82
170,47065002300,"Census Tract 23, Hamilton County, Tennessee",493,0,0.0,493,20.02,"Census Tract 23, Hamilton County, Tennessee",471,24,5.1,447,20.94,"Census Tract 23, Hamilton County, Tennessee",580,19,3.28,561,21.29
171,47065001900,"Census Tract 19, Hamilton County, Tennessee",1142,0,0.0,1142,23.73,"Census Tract 19, Hamilton County, Tennessee",1142,0,0.0,1142,23.32,"Census Tract 19, Hamilton County, Tennessee",1360,37,2.72,1323,24.23
172,47065010700,"Census Tract 107, Hamilton County, Tennessee",1431,53,3.7,1378,21.13,"Census Tract 107, Hamilton County, Tennessee",1414,71,5.02,1343,22.48,"Census Tract 107, Hamilton County, Tennessee",1488,99,6.65,1389,21.52
173,47065001600,"Census Tract 16, Hamilton County, Tennessee",407,0,0.0,407,29.18,"Census Tract 16, Hamilton County, Tennessee",559,0,0.0,559,31.96,"Census Tract 16, Hamilton County, Tennessee",624,0,0.0,624,33.72
174,47065010432,"Census Tract 104.32, Hamilton County, Tennessee",2769,62,2.24,2707,25.95,"Census Tract 104.32, Hamilton County, Tennessee",3194,127,3.98,3067,26.39,"Census Tract 104.32, Hamilton County, Tennessee",3202,151,4.72,3051,26.59
175,47065000700,"Census Tract 7, Hamilton County, Tennessee",2303,103,4.47,2200,20.97,"Census Tract 7, Hamilton County, Tennessee",2480,139,5.6,2341,19.31,"Census Tract 7, Hamilton County, Tennessee",2815,142,5.04,2673,20.34
176,47065002600,"Census Tract 26, Hamilton County, Tennessee",908,55,6.06,853,20.95,"Census Tract 26, Hamilton County, Tennessee",825,36,4.36,789,25.37,"Census Tract 26, Hamilton County, Tennessee",849,55,6.48,794,19.02
177,47163042400,"Census Tract 424, Sullivan County, Tennessee",1245,47,3.78,1198,26.47,"Census Tract 424, Sullivan County, Tennessee",1392,32,2.3,1360,25.23,"Census Tract 424, Sullivan County, Tennessee",1549,5,0.32,1544,24.01
178,47037011300,"Census Tract 113, Davidson County, Tennessee",2367,33,1.39,2334,27.22,"Census Tract 113, Davidson County, Tennessee",2659,96,3.61,2563,27.02,"Census Tract 113, Davidson County, Tennessee",2832,134,4.73,2698,27.93
179,47037017901,"Census Tract 179.01, Davidson County, Tennessee",2402,280,11.66,2122,19.51,"Census Tract 179.01, Davidson County, Tennessee",2063,342,16.58,1721,21.76,"Census Tract 179.01, Davidson County, Tennessee",2176,364,16.73,1812,23.46
180,47105060600,"Census Tract 606, Loudon County, Tennessee",1751,47,2.68,1704,25.87,"Census Tract 606, Loudon County, Tennessee",1977,84,4.25,1893,25.2,"Census Tract 606, Loudon County, Tennessee",2221,63,2.84,2158,23.91
181,47105060100,"Census Tract 601, Loudon County, Tennessee",2256,43,1.91,2213,26.47,"Census Tract 601, Loudon County, Tennessee",2281,35,1.53,2246,27.34,"Census Tract 601, Loudon County, Tennessee",2525,0,0.0,2525,26.93
182,47105060400,"Census Tract 604, Loudon County, Tennessee",2056,112,5.45,1944,34.05,"Census Tract 604, Loudon County, Tennessee",2160,209,9.68,1951,31.76,"Census Tract 604, Loudon County, Tennessee",2186,246,11.25,1940,33.07
183,47105060700,"Census Tract 607, Loudon County, Tennessee",1263,38,3.01,1225,28.17,"Census Tract 607, Loudon County, Tennessee",1067,25,2.34,1042,27.84,"Census Tract 607, Loudon County, Tennessee",1141,124,10.87,1017,30.45
184,47037015620,"Census Tract 156.20, Davidson County, Tennessee",3840,43,1.12,3797,36.17,"Census Tract 156.20, Davidson County, Tennessee",3965,16,0.4,3949,38.82,"Census Tract 156.20, Davidson County, Tennessee",3532,134,3.79,3398,36.67
185,47005963300,"Census Tract 9633, Benton County, Tennessee",1225,0,0.0,1225,23.43,"Census Tract 9633, Benton County, Tennessee",1268,0,0.0,1268,22.18,"Census Tract 9633, Benton County, Tennessee",1273,0,0.0,1273,19.68
186,47005963100,"Census Tract 9631, Benton County, Tennessee",1096,7,0.64,1089,29.97,"Census Tract 9631, Benton County, Tennessee",1042,9,0.86,1033,31.13,"Census Tract 9631, Benton County, Tennessee",1018,0,0.0,1018,31.44
187,47005963400,"Census Tract 9634, Benton County, Tennessee",1497,55,3.67,1442,26.09,"Census Tract 9634, Benton County, Tennessee",1373,9,0.66,1364,21.87,"Census Tract 9634, Benton County, Tennessee",1460,12,0.82,1448,22.76
188,47005963200,"Census Tract 9632, Benton County, Tennessee",821,15,1.83,806,38.12,"Census Tract 9632, Benton County, Tennessee",722,5,0.69,717,41.61,"Census Tract 9632, Benton County, Tennessee",712,10,1.4,702,40.2
189,47005963000,"Census Tract 9630, Benton County, Tennessee",1028,52,5.06,976,35.11,"Census Tract 9630, Benton County, Tennessee",1123,39,3.47,1084,37.32,"Census Tract 9630, Benton County, Tennessee",1201,34,2.83,1167,37.09
190,47015960100,"Census Tract 9601, Cannon County, Tennessee",1630,55,3.37,1575,39.68,"Census Tract 9601, Cannon County, Tennessee",1498,84,5.61,1414,41.77,"Census Tract 9601, Cannon County, Tennessee",1604,58,3.62,1546,41.93
191,47015960200,"Census Tract 9602, Cannon County, Tennessee",2484,38,1.53,2446,36.0,"Census Tract 9602, Cannon County, Tennessee",2632,74,2.81,2558,36.2,"Census Tract 9602, Cannon County, Tennessee",2826,66,2.34,2760,37.62
192,47015960300,"Census Tract 9603, Cannon County, Tennessee",1501,100,6.66,1401,44.83,"Census Tract 9603, Cannon County, Tennessee",1859,164,8.82,1695,44.02,"Census Tract 9603, Cannon County, Tennessee",1950,167,8.56,1783,40.5
193,47021070300,"Census Tract 703, Cheatham County, Tennessee",1405,4,0.28,1401,38.59,"Census Tract 703, Cheatham County, Tennessee",1353,0,0.0,1353,41.2,"Census Tract 703, Cheatham County, Tennessee",1553,0,0.0,1553,39.32
194,47021070102,"Census Tract 701.02, Cheatham County, Tennessee",1727,77,4.46,1650,41.64,"Census Tract 701.02, Cheatham County, Tennessee",1862,71,3.81,1791,40.73,"Census Tract 701.02, Cheatham County, Tennessee",1808,12,0.66,1796,43.4
195,47023970300,"Census Tract 9703, Chester County, Tennessee",2740,44,1.61,2696,31.71,"Census Tract 9703, Chester County, Tennessee",2357,38,1.61,2319,30.96,"Census Tract 9703, Chester County, Tennessee",2251,57,2.53,2194,32.69
196,47163040200,"Census Tract 402, Sullivan County, Tennessee",795,44,5.53,751,21.46,"Census Tract 402, Sullivan County, Tennessee",812,33,4.06,779,23.36,"Census Tract 402, Sullivan County, Tennessee",727,16,2.2,711,24.22
197,47163040900,"Census Tract 409, Sullivan County, Tennessee",1287,61,4.74,1226,22.2,"Census Tract 409, Sullivan County, Tennessee",1360,48,3.53,1312,22.85,"Census Tract 409, Sullivan County, Tennessee",1125,10,0.89,1115,23.11
198,47163041600,"Census Tract 416, Sullivan County, Tennessee",1056,52,4.92,1004,20.6,"Census Tract 416, Sullivan County, Tennessee",966,36,3.73,930,22.97,"Census Tract 416, Sullivan County, Tennessee",1028,27,2.63,1001,24.63
199,47163041500,"Census Tract 415, Sullivan County, Tennessee",1228,19,1.55,1209,25.92,"Census Tract 415, Sullivan County, Tennessee",1142,42,3.68,1100,23.49,"Census Tract 415, Sullivan County, Tennessee",1182,97,8.21,1085,25.11
200,47163041800,"Census Tract 418, Sullivan County, Tennessee",1762,8,0.45,1754,21.92,"Census Tract 418, Sullivan County, Tennessee",1939,59,3.04,1880,23.26,"Census Tract 418, Sullivan County, Tennessee",1750,55,3.14,1695,25.96
201,47163042100,"Census Tract 421, Sullivan County, Tennessee",2325,43,1.85,2282,27.02,"Census Tract 421, Sullivan County, Tennessee",2226,100,4.49,2126,29.24,"Census Tract 421, Sullivan County, Tennessee",2329,133,5.71,2196,28.44
202,47163042300,"Census Tract 423, Sullivan County, Tennessee",3062,46,1.5,3016,27.05,"Census Tract 423, Sullivan County, Tennessee",2876,86,2.99,2790,24.7,"Census Tract 423, Sullivan County, Tennessee",2676,77,2.88,2599,22.49
203,47163042600,"Census Tract 426, Sullivan County, Tennessee",1853,0,0.0,1853,21.18,"Census Tract 426, Sullivan County, Tennessee",1829,7,0.38,1822,22.09,"Census Tract 426, Sullivan County, Tennessee",1690,76,4.5,1614,22.93
204,47163042801,"Census Tract 428.01, Sullivan County, Tennessee",1284,56,4.36,1228,27.85,"Census Tract 428.01, Sullivan County, Tennessee",1336,46,3.44,1290,28.18,"Census Tract 428.01, Sullivan County, Tennessee",1264,23,1.82,1241,27.09
205,47163042900,"Census Tract 429, Sullivan County, Tennessee",1915,77,4.02,1838,32.15,"Census Tract 429, Sullivan County, Tennessee",1993,58,2.91,1935,27.75,"Census Tract 429, Sullivan County, Tennessee",1974,71,3.6,1903,24.7
206,47163043000,"Census Tract 430, Sullivan County, Tennessee",1884,11,0.58,1873,25.73,"Census Tract 430, Sullivan County, Tennessee",1857,29,1.56,1828,26.7,"Census Tract 430, Sullivan County, Tennessee",1760,71,4.03,1689,27.0
207,47049965100,"Census Tract 9651, Fentress County, Tennessee",1252,40,3.19,1212,19.55,"Census Tract 9651, Fentress County, Tennessee",1505,32,2.13,1473,22.41,"Census Tract 9651, Fentress County, Tennessee",1457,14,0.96,1443,24.23
208,47023970100,"Census Tract 9701, Chester County, Tennessee",2468,107,4.34,2361,31.79,"Census Tract 9701, Chester County, Tennessee",2556,88,3.44,2468,34.1,"Census Tract 9701, Chester County, Tennessee",2847,158,5.55,2689,39.88
209,47023970200,"Census Tract 9702, Chester County, Tennessee",1918,73,3.81,1845,28.7,"Census Tract 9702, Chester County, Tennessee",2038,84,4.12,1954,22.93,"Census Tract 9702, Chester County, Tennessee",1824,126,6.91,1698,22.86
210,47049965200,"Census Tract 9652, Fentress County, Tennessee",1834,28,1.53,1806,30.67,"Census Tract 9652, Fentress County, Tennessee",1928,155,8.04,1773,24.68,"Census Tract 9652, Fentress County, Tennessee",1945,166,8.53,1779,28.28
211,47049965300,"Census Tract 9653, Fentress County, Tennessee",1692,48,2.84,1644,33.41,"Census Tract 9653, Fentress County, Tennessee",1752,136,7.76,1616,40.28,"Census Tract 9653, Fentress County, Tennessee",2151,81,3.77,2070,37.32
212,47049965000,"Census Tract 9650, Fentress County, Tennessee",1065,5,0.47,1060,31.61,"Census Tract 9650, Fentress County, Tennessee",1308,50,3.82,1258,28.01,"Census Tract 9650, Fentress County, Tennessee",1366,83,6.08,1283,28.6
213,47057500300,"Census Tract 5003, Grainger County, Tennessee",2522,99,3.93,2423,41.78,"Census Tract 5003, Grainger County, Tennessee",2476,129,5.21,2347,41.39,"Census Tract 5003, Grainger County, Tennessee",2451,222,9.06,2229,39.86
214,47057500100,"Census Tract 5001, Grainger County, Tennessee",1362,19,1.4,1343,44.53,"Census Tract 5001, Grainger County, Tennessee",1518,48,3.16,1470,47.27,"Census Tract 5001, Grainger County, Tennessee",1763,84,4.76,1679,43.66
215,47123925400,"Census Tract 9254, Monroe County, Tennessee",2417,72,2.98,2345,33.11,"Census Tract 9254, Monroe County, Tennessee",2792,158,5.66,2634,32.11,"Census Tract 9254, Monroe County, Tennessee",3654,124,3.39,3530,31.59
216,47057500200,"Census Tract 5002, Grainger County, Tennessee",2002,35,1.75,1967,41.02,"Census Tract 5002, Grainger County, Tennessee",2283,81,3.55,2202,40.49,"Census Tract 5002, Grainger County, Tennessee",2537,211,8.32,2326,41.91
217,47125100200,"Census Tract 1002, Montgomery County, Tennessee",881,27,3.06,854,24.8,"Census Tract 1002, Montgomery County, Tennessee",637,17,2.67,620,24.57,"Census Tract 1002, Montgomery County, Tennessee",687,33,4.8,654,32.24
218,47125100602,"Census Tract 1006.02, Montgomery County, Tennessee",1311,12,0.92,1299,25.42,"Census Tract 1006.02, Montgomery County, Tennessee",1282,9,0.7,1273,25.98,"Census Tract 1006.02, Montgomery County, Tennessee",1388,17,1.22,1371,26.89
219,47165021103,"Census Tract 211.03, Sumner County, Tennessee",2992,183,6.12,2809,34.71,"Census Tract 211.03, Sumner County, Tennessee",3029,129,4.26,2900,35.23,"Census Tract 211.03, Sumner County, Tennessee",3408,215,6.31,3193,37.1
220,47165021201,"Census Tract 212.01, Sumner County, Tennessee",3615,257,7.11,3358,37.12,"Census Tract 212.01, Sumner County, Tennessee",3660,285,7.79,3375,33.32,"Census Tract 212.01, Sumner County, Tennessee",3515,437,12.43,3078,32.43
221,47185935000,"Census Tract 9350, White County, Tennessee",1289,8,0.62,1281,32.09,"Census Tract 9350, White County, Tennessee",1428,39,2.73,1389,33.86,"Census Tract 9350, White County, Tennessee",1541,59,3.83,1482,32.88
222,47185935200,"Census Tract 9352, White County, Tennessee",1551,61,3.93,1490,30.06,"Census Tract 9352, White County, Tennessee",1654,70,4.23,1584,32.01,"Census Tract 9352, White County, Tennessee",1533,43,2.8,1490,32.5
223,47185935500,"Census Tract 9355, White County, Tennessee",1213,23,1.9,1190,31.58,"Census Tract 9355, White County, Tennessee",1295,11,0.85,1284,31.82,"Census Tract 9355, White County, Tennessee",1370,46,3.36,1324,33.66
224,47185935400,"Census Tract 9354, White County, Tennessee",1294,14,1.08,1280,21.35,"Census Tract 9354, White County, Tennessee",1260,15,1.19,1245,19.8,"Census Tract 9354, White County, Tennessee",1160,42,3.62,1118,22.97
225,47185935300,"Census Tract 9353, White County, Tennessee",2129,92,4.32,2037,29.47,"Census Tract 9353, White County, Tennessee",1886,49,2.6,1837,30.63,"Census Tract 9353, White County, Tennessee",2206,71,3.22,2135,21.63
226,47185935100,"Census Tract 9351, White County, Tennessee",2024,0,0.0,2024,30.4,"Census Tract 9351, White County, Tennessee",2203,16,0.73,2187,27.23,"Census Tract 9351, White County, Tennessee",2349,27,1.15,2322,32.11
227,47157003400,"Census Tract 34, Shelby County, Tennessee",1353,37,2.73,1316,21.83,"Census Tract 34, Shelby County, Tennessee",1322,91,6.88,1231,23.23,"Census Tract 34, Shelby County, Tennessee",1365,97,7.11,1268,25.44
228,47123925000,"Census Tract 9250, Monroe County, Tennessee",2687,109,4.06,2578,34.72,"Census Tract 9250, Monroe County, Tennessee",2577,71,2.76,2506,33.98,"Census Tract 9250, Monroe County, Tennessee",2922,139,4.76,2783,33.66
229,47123925300,"Census Tract 9253, Monroe County, Tennessee",2882,57,1.98,2825,31.71,"Census Tract 9253, Monroe County, Tennessee",2941,20,0.68,2921,32.26,"Census Tract 9253, Monroe County, Tennessee",2919,10,0.34,2909,35.81
230,47123925200,"Census Tract 9252, Monroe County, Tennessee",1735,57,3.29,1678,27.28,"Census Tract 9252, Monroe County, Tennessee",1433,0,0.0,1433,29.99,"Census Tract 9252, Monroe County, Tennessee",1711,9,0.53,1702,28.2
231,47079969500,"Census Tract 9695, Henry County, Tennessee",1971,63,3.2,1908,18.8,"Census Tract 9695, Henry County, Tennessee",2166,26,1.2,2140,16.89,"Census Tract 9695, Henry County, Tennessee",2230,35,1.57,2195,20.3
232,47123925100,"Census Tract 9251, Monroe County, Tennessee",3216,39,1.21,3177,30.32,"Census Tract 9251, Monroe County, Tennessee",3260,16,0.49,3244,28.25,"Census Tract 9251, Monroe County, Tennessee",3279,76,2.32,3203,27.16
233,47157000100,"Census Tract 1, Shelby County, Tennessee",3351,55,1.64,3296,22.13,"Census Tract 1, Shelby County, Tennessee",3612,100,2.77,3512,22.2,"Census Tract 1, Shelby County, Tennessee",3541,80,2.26,3461,21.48
234,47157000300,"Census Tract 3, Shelby County, Tennessee",305,8,2.62,297,33.75,"Census Tract 3, Shelby County, Tennessee",341,8,2.35,333,33.64,"Census Tract 3, Shelby County, Tennessee",244,0,0.0,244,28.84
235,47157000400,"Census Tract 4, Shelby County, Tennessee",544,13,2.39,531,36.15,"Census Tract 4, Shelby County, Tennessee",410,3,0.73,407,37.95,"Census Tract 4, Shelby County, Tennessee",372,5,1.34,367,42.67
236,47079969000,"Census Tract 9690, Henry County, Tennessee",1839,36,1.96,1803,36.34,"Census Tract 9690, Henry County, Tennessee",1615,54,3.34,1561,33.36,"Census Tract 9690, Henry County, Tennessee",1271,64,5.04,1207,32.33
237,47079969400,"Census Tract 9694, Henry County, Tennessee",681,6,0.88,675,16.04,"Census Tract 9694, Henry County, Tennessee",715,6,0.84,709,18.56,"Census Tract 9694, Henry County, Tennessee",770,0,0.0,770,20.61
238,47079969800,"Census Tract 9698, Henry County, Tennessee",1010,30,2.97,980,27.37,"Census Tract 9698, Henry County, Tennessee",958,13,1.36,945,29.97,"Census Tract 9698, Henry County, Tennessee",994,20,2.01,974,28.37
239,47079969200,"Census Tract 9692, Henry County, Tennessee",646,41,6.35,605,26.72,"Census Tract 9692, Henry County, Tennessee",657,57,8.68,600,30.46,"Census Tract 9692, Henry County, Tennessee",772,72,9.33,700,26.7
240,47079969700,"Census Tract 9697, Henry County, Tennessee",879,31,3.53,848,28.65,"Census Tract 9697, Henry County, Tennessee",623,42,6.74,581,28.1,"Census Tract 9697, Henry County, Tennessee",648,35,5.4,613,35.15
241,47079969100,"Census Tract 9691, Henry County, Tennessee",1107,79,7.14,1028,31.16,"Census Tract 9691, Henry County, Tennessee",1294,68,5.26,1226,28.91,"Census Tract 9691, Henry County, Tennessee",1295,47,3.63,1248,27.2
242,47081950100,"Census Tract 9501, Hickman County, Tennessee",2383,51,2.14,2332,51.08,"Census Tract 9501, Hickman County, Tennessee",2712,93,3.43,2619,48.78,"Census Tract 9501, Hickman County, Tennessee",2672,32,1.2,2640,46.02
243,47079969300,"Census Tract 9693, Henry County, Tennessee",1164,67,5.76,1097,22.48,"Census Tract 9693, Henry County, Tennessee",1202,92,7.65,1110,20.77,"Census Tract 9693, Henry County, Tennessee",972,39,4.01,933,19.56
244,47081950400,"Census Tract 9504, Hickman County, Tennessee",787,46,5.84,741,42.21,"Census Tract 9504, Hickman County, Tennessee",859,16,1.86,843,42.54,"Census Tract 9504, Hickman County, Tennessee",863,18,2.09,845,41.87
245,47081950200,"Census Tract 9502, Hickman County, Tennessee",2317,61,2.63,2256,42.01,"Census Tract 9502, Hickman County, Tennessee",2531,199,7.86,2332,43.52,"Census Tract 9502, Hickman County, Tennessee",3057,253,8.28,2804,48.17
246,47081950500,"Census Tract 9505, Hickman County, Tennessee",374,37,9.89,337,49.53,"Census Tract 9505, Hickman County, Tennessee",354,17,4.8,337,41.19,"Census Tract 9505, Hickman County, Tennessee",542,38,7.01,504,48.49
247,47145030100,"Census Tract 301, Roane County, Tennessee",1514,64,4.23,1450,29.86,"Census Tract 301, Roane County, Tennessee",1442,77,5.34,1365,30.62,"Census Tract 301, Roane County, Tennessee",1391,82,5.9,1309,29.69
248,47145030300,"Census Tract 303, Roane County, Tennessee",2193,120,5.47,2073,40.63,"Census Tract 303, Roane County, Tennessee",2590,163,6.29,2427,42.13,"Census Tract 303, Roane County, Tennessee",2624,132,5.03,2492,42.65
249,47145030800,"Census Tract 308, Roane County, Tennessee",1730,39,2.25,1691,33.52,"Census Tract 308, Roane County, Tennessee",2039,38,1.86,2001,35.11,"Census Tract 308, Roane County, Tennessee",2084,68,3.26,2016,36.16
250,47145030900,"Census Tract 309, Roane County, Tennessee",2069,24,1.16,2045,35.16,"Census Tract 309, Roane County, Tennessee",2150,71,3.3,2079,34.94,"Census Tract 309, Roane County, Tennessee",2331,108,4.63,2223,32.68
251,47145030700,"Census Tract 307, Roane County, Tennessee",1646,63,3.83,1583,26.77,"Census Tract 307, Roane County, Tennessee",1479,66,4.46,1413,26.29,"Census Tract 307, Roane County, Tennessee",1290,65,5.04,1225,27.73
252,47145030500,"Census Tract 305, Roane County, Tennessee",1328,20,1.51,1308,26.81,"Census Tract 305, Roane County, Tennessee",1319,16,1.21,1303,26.63,"Census Tract 305, Roane County, Tennessee",1275,48,3.76,1227,28.91
253,47145030202,"Census Tract 302.02, Roane County, Tennessee",2823,118,4.18,2705,25.67,"Census Tract 302.02, Roane County, Tennessee",3001,122,4.07,2879,29.16,"Census Tract 302.02, Roane County, Tennessee",3245,250,7.7,2995,31.94
254,47145030600,"Census Tract 306, Roane County, Tennessee",1518,35,2.31,1483,30.61,"Census Tract 306, Roane County, Tennessee",1485,34,2.29,1451,30.27,"Census Tract 306, Roane County, Tennessee",1546,42,2.72,1504,30.8
255,47145030201,"Census Tract 302.01, Roane County, Tennessee",2498,61,2.44,2437,37.33,"Census Tract 302.01, Roane County, Tennessee",2585,48,1.86,2537,34.49,"Census Tract 302.01, Roane County, Tennessee",3064,140,4.57,2924,30.18
256,47145030400,"Census Tract 304, Roane County, Tennessee",2937,63,2.15,2874,33.14,"Census Tract 304, Roane County, Tennessee",2773,63,2.27,2710,32.29,"Census Tract 304, Roane County, Tennessee",2731,61,2.23,2670,35.44
257,47159975400,"Census Tract 9754, Smith County, Tennessee",2053,38,1.85,2015,33.93,"Census Tract 9754, Smith County, Tennessee",2287,46,2.01,2241,33.4,"Census Tract 9754, Smith County, Tennessee",2565,93,3.63,2472,31.7
258,47159975100,"Census Tract 9751, Smith County, Tennessee",951,27,2.84,924,28.7,"Census Tract 9751, Smith County, Tennessee",1149,10,0.87,1139,27.45,"Census Tract 9751, Smith County, Tennessee",1312,0,0.0,1312,31.84
259,47159975200,"Census Tract 9752, Smith County, Tennessee",2422,85,3.51,2337,33.48,"Census Tract 9752, Smith County, Tennessee",2304,41,1.78,2263,34.33,"Census Tract 9752, Smith County, Tennessee",2426,164,6.76,2262,42.66
260,47115050101,"Census Tract 501.01, Marion County, Tennessee",1586,132,8.32,1454,43.85,"Census Tract 501.01, Marion County, Tennessee",1627,62,3.81,1565,44.58,"Census Tract 501.01, Marion County, Tennessee",1631,53,3.25,1578,42.63
261,47159975000,"Census Tract 9750, Smith County, Tennessee",1776,40,2.25,1736,40.76,"Census Tract 9750, Smith County, Tennessee",1825,61,3.34,1764,42.27,"Census Tract 9750, Smith County, Tennessee",1887,102,5.41,1785,47.13
262,47159975300,"Census Tract 9753, Smith County, Tennessee",753,14,1.86,739,37.68,"Census Tract 9753, Smith County, Tennessee",720,0,0.0,720,40.65,"Census Tract 9753, Smith County, Tennessee",812,0,0.0,812,41.72
263,47073050400,"Census Tract 504, Hawkins County, Tennessee",2333,89,3.81,2244,33.48,"Census Tract 504, Hawkins County, Tennessee",2402,64,2.66,2338,36.41,"Census Tract 504, Hawkins County, Tennessee",2409,66,2.74,2343,31.78
264,47073050700,"Census Tract 507, Hawkins County, Tennessee",1315,0,0.0,1315,38.15,"Census Tract 507, Hawkins County, Tennessee",1378,21,1.52,1357,37.11,"Census Tract 507, Hawkins County, Tennessee",1342,26,1.94,1316,39.16
265,47093006104,"Census Tract 61.04, Knox County, Tennessee",2316,137,5.92,2179,24.67,"Census Tract 61.04, Knox County, Tennessee",2665,87,3.26,2578,28.38,"Census Tract 61.04, Knox County, Tennessee",2696,160,5.93,2536,31.89
266,47073050900,"Census Tract 509, Hawkins County, Tennessee",1222,37,3.03,1185,31.23,"Census Tract 509, Hawkins County, Tennessee",1261,25,1.98,1236,30.49,"Census Tract 509, Hawkins County, Tennessee",1119,49,4.38,1070,33.26
267,47073050100,"Census Tract 501, Hawkins County, Tennessee",1514,36,2.38,1478,37.59,"Census Tract 501, Hawkins County, Tennessee",1466,32,2.18,1434,33.85,"Census Tract 501, Hawkins County, Tennessee",1366,7,0.51,1359,31.34
268,47187050207,"Census Tract 502.07, Williamson County, Tennessee",1646,112,6.8,1534,31.96,"Census Tract 502.07, Williamson County, Tennessee",1965,172,8.75,1793,33.12,"Census Tract 502.07, Williamson County, Tennessee",2020,204,10.1,1816,35.19
269,47187050102,"Census Tract 501.02, Williamson County, Tennessee",2140,112,5.23,2028,33.54,"Census Tract 501.02, Williamson County, Tennessee",2178,212,9.73,1966,37.96,"Census Tract 501.02, Williamson County, Tennessee",2428,251,10.34,2177,41.6
270,47187050504,"Census Tract 505.04, Williamson County, Tennessee",1997,89,4.46,1908,43.88,"Census Tract 505.04, Williamson County, Tennessee",2061,123,5.97,1938,43.89,"Census Tract 505.04, Williamson County, Tennessee",2122,167,7.87,1955,44.4
271,47187051001,"Census Tract 510.01, Williamson County, Tennessee",3198,231,7.22,2967,29.09,"Census Tract 510.01, Williamson County, Tennessee",3547,363,10.23,3184,30.24,"Census Tract 510.01, Williamson County, Tennessee",3702,471,12.72,3231,30.36
272,47187051100,"Census Tract 511, Williamson County, Tennessee",3366,383,11.38,2983,41.22,"Census Tract 511.00, Williamson County, Tennessee",3676,378,10.28,3298,40.42,"Census Tract 511.00, Williamson County, Tennessee",4438,526,11.85,3912,35.49
273,47037011400,"Census Tract 114, Davidson County, Tennessee",2530,169,6.68,2361,28.37,"Census Tract 114, Davidson County, Tennessee",2829,155,5.48,2674,26.8,"Census Tract 114, Davidson County, Tennessee",2720,255,9.38,2465,26.86
274,47179060700,"Census Tract 607, Washington County, Tennessee",552,7,1.27,545,17.77,"Census Tract 607, Washington County, Tennessee",588,8,1.36,580,17.97,"Census Tract 607, Washington County, Tennessee",550,0,0.0,550,17.89
275,47179060800,"Census Tract 608, Washington County, Tennessee",1565,18,1.15,1547,18.16,"Census Tract 608, Washington County, Tennessee",1528,19,1.24,1509,19.44,"Census Tract 608, Washington County, Tennessee",1433,70,4.88,1363,20.64
276,47179061000,"Census Tract 610, Washington County, Tennessee",871,32,3.67,839,21.23,"Census Tract 610, Washington County, Tennessee",1101,42,3.81,1059,18.8,"Census Tract 610, Washington County, Tennessee",1230,38,3.09,1192,16.39
277,47115050202,"Census Tract 502.02, Marion County, Tennessee",2408,161,6.69,2247,32.97,"Census Tract 502.02, Marion County, Tennessee",2439,233,9.55,2206,34.55,"Census Tract 502.02, Marion County, Tennessee",2553,227,8.89,2326,35.42
278,47115050102,"Census Tract 501.02, Marion County, Tennessee",2203,107,4.86,2096,45.48,"Census Tract 501.02, Marion County, Tennessee",2167,85,3.92,2082,47.15,"Census Tract 501.02, Marion County, Tennessee",2661,105,3.95,2556,45.71
279,47115050302,"Census Tract 503.02, Marion County, Tennessee",1474,23,1.56,1451,34.15,"Census Tract 503.02, Marion County, Tennessee",1414,33,2.33,1381,32.62,"Census Tract 503.02, Marion County, Tennessee",1192,53,4.45,1139,35.9
280,47115050301,"Census Tract 503.01, Marion County, Tennessee",2127,49,2.3,2078,27.16,"Census Tract 503.01, Marion County, Tennessee",2155,57,2.65,2098,25.46,"Census Tract 503.01, Marion County, Tennessee",2207,60,2.72,2147,23.68
281,47115050201,"Census Tract 502.01, Marion County, Tennessee",1915,61,3.19,1854,33.22,"Census Tract 502.01, Marion County, Tennessee",1998,34,1.7,1964,28.56,"Census Tract 502.01, Marion County, Tennessee",2006,37,1.84,1969,33.39
282,47157010630,"Census Tract 106.30, Shelby County, Tennessee",1684,22,1.31,1662,25.11,"Census Tract 106.30, Shelby County, Tennessee",1332,47,3.53,1285,25.37,"Census Tract 106.30, Shelby County, Tennessee",1235,52,4.21,1183,25.87
283,47137925100,"Census Tract 9251, Pickett County, Tennessee",2033,55,2.71,1978,30.01,"Census Tract 9251, Pickett County, Tennessee",2112,107,5.07,2005,30.28,"Census Tract 9251, Pickett County, Tennessee",1814,92,5.07,1722,31.69
284,47037010702,"Census Tract 107.02, Davidson County, Tennessee",1345,0,0.0,1345,33.88,"Census Tract 107.02, Davidson County, Tennessee",1404,50,3.56,1354,31.21,"Census Tract 107.02, Davidson County, Tennessee",1422,80,5.63,1342,34.44
285,47037010801,"Census Tract 108.01, Davidson County, Tennessee",2423,18,0.74,2405,33.83,"Census Tract 108.01, Davidson County, Tennessee",3101,83,2.68,3018,34.06,"Census Tract 108.01, Davidson County, Tennessee",3081,72,2.34,3009,31.52
286,47157020635,"Census Tract 206.35, Shelby County, Tennessee",1268,41,3.23,1227,30.08,"Census Tract 206.35, Shelby County, Tennessee",1250,37,2.96,1213,27.22,"Census Tract 206.35, Shelby County, Tennessee",1302,26,2.0,1276,26.29
287,47157011200,"Census Tract 112, Shelby County, Tennessee",579,33,5.7,546,30.07,"Census Tract 112, Shelby County, Tennessee",477,29,6.08,448,31.14,"Census Tract 112, Shelby County, Tennessee",359,17,4.74,342,38.31
288,47157011300,"Census Tract 113, Shelby County, Tennessee",574,30,5.23,544,21.99,"Census Tract 113, Shelby County, Tennessee",489,50,10.22,439,23.77,"Census Tract 113, Shelby County, Tennessee",456,56,12.28,400,26.38
289,47157011400,"Census Tract 114, Shelby County, Tennessee",848,41,4.83,807,24.17,"Census Tract 114, Shelby County, Tennessee",915,26,2.84,889,33.15,"Census Tract 114, Shelby County, Tennessee",924,0,0.0,924,32.25
290,47157011600,"Census Tract 116, Shelby County, Tennessee",734,7,0.95,727,28.56,"Census Tract 116, Shelby County, Tennessee",568,15,2.64,553,27.73,"Census Tract 116, Shelby County, Tennessee",651,18,2.76,633,25.25
291,47157011500,"Census Tract 115, Shelby County, Tennessee",741,9,1.21,732,27.57,"Census Tract 115, Shelby County, Tennessee",827,0,0.0,827,24.5,"Census Tract 115, Shelby County, Tennessee",719,0,0.0,719,24.33
292,47125100700,"Census Tract 1007, Montgomery County, Tennessee",517,16,3.09,501,22.13,"Census Tract 1007, Montgomery County, Tennessee",612,54,8.82,558,25.66,"Census Tract 1007, Montgomery County, Tennessee",628,49,7.8,579,29.07
293,47125100800,"Census Tract 1008, Montgomery County, Tennessee",1038,55,5.3,983,26.43,"Census Tract 1008, Montgomery County, Tennessee",987,25,2.53,962,27.31,"Census Tract 1008, Montgomery County, Tennessee",1069,12,1.12,1057,27.5
294,47125101101,"Census Tract 1011.01, Montgomery County, Tennessee",1255,52,4.14,1203,30.18,"Census Tract 1011.01, Montgomery County, Tennessee",1171,87,7.43,1084,26.72,"Census Tract 1011.01, Montgomery County, Tennessee",1009,101,10.01,908,33.14
295,47125101002,"Census Tract 1010.02, Montgomery County, Tennessee",1676,11,0.66,1665,29.15,"Census Tract 1010.02, Montgomery County, Tennessee",1710,92,5.38,1618,29.75,"Census Tract 1010.02, Montgomery County, Tennessee",1732,146,8.43,1586,34.56
296,47157011800,"Census Tract 118, Shelby County, Tennessee",2770,31,1.12,2739,23.68,"Census Tract 118, Shelby County, Tennessee",2812,69,2.45,2743,24.93,"Census Tract 118, Shelby County, Tennessee",2837,87,3.07,2750,24.97
297,47157022700,"Census Tract 227, Shelby County, Tennessee",2511,0,0.0,2511,27.05,"Census Tract 227, Shelby County, Tennessee",2401,0,0.0,2401,31.15,"Census Tract 227, Shelby County, Tennessee",2798,19,0.68,2779,27.2
298,47157007821,"Census Tract 78.21, Shelby County, Tennessee",1377,15,1.09,1362,23.64,"Census Tract 78.21, Shelby County, Tennessee",1449,82,5.66,1367,23.07,"Census Tract 78.21, Shelby County, Tennessee",1665,78,4.68,1587,25.59
299,47157007822,"Census Tract 78.22, Shelby County, Tennessee",600,5,0.83,595,25.24,"Census Tract 78.22, Shelby County, Tennessee",621,8,1.29,613,23.8,"Census Tract 78.22, Shelby County, Tennessee",527,0,0.0,527,24.34
300,47157007900,"Census Tract 79, Shelby County, Tennessee",2042,0,0.0,2042,24.2,"Census Tract 79, Shelby County, Tennessee",2074,0,0.0,2074,23.71,"Census Tract 79, Shelby County, Tennessee",2150,0,0.0,2150,22.22
301,47157008000,"Census Tract 80, Shelby County, Tennessee",2319,13,0.56,2306,20.72,"Census Tract 80, Shelby County, Tennessee",2443,0,0.0,2443,22.39,"Census Tract 80, Shelby County, Tennessee",1932,0,0.0,1932,22.43
302,47157008110,"Census Tract 81.10, Shelby County, Tennessee",882,11,1.25,871,30.85,"Census Tract 81.10, Shelby County, Tennessee",875,21,2.4,854,29.73,"Census Tract 81.10, Shelby County, Tennessee",782,31,3.96,751,31.64
303,47157021341,"Census Tract 213.41, Shelby County, Tennessee",2530,251,9.92,2279,24.12,"Census Tract 213.41, Shelby County, Tennessee",2704,262,9.69,2442,23.88,"Census Tract 213.41, Shelby County, Tennessee",2537,219,8.63,2318,24.54
304,47157021612,"Census Tract 216.12, Shelby County, Tennessee",2798,101,3.61,2697,32.46,"Census Tract 216.12, Shelby County, Tennessee",2676,128,4.78,2548,29.91,"Census Tract 216.12, Shelby County, Tennessee",2455,119,4.85,2336,32.29
305,47157006600,"Census Tract 66, Shelby County, Tennessee",1188,32,2.69,1156,22.31,"Census Tract 66, Shelby County, Tennessee",1217,66,5.42,1151,20.95,"Census Tract 66, Shelby County, Tennessee",1243,21,1.69,1222,19.59
306,47021070201,"Census Tract 702.01, Cheatham County, Tennessee",2255,166,7.36,2089,35.94,"Census Tract 702.01, Cheatham County, Tennessee",2179,131,6.01,2048,38.81,"Census Tract 702.01, Cheatham County, Tennessee",2379,180,7.57,2199,40.99
307,47021070401,"Census Tract 704.01, Cheatham County, Tennessee",1165,75,6.44,1090,36.55,"Census Tract 704.01, Cheatham County, Tennessee",1185,56,4.73,1129,41.34,"Census Tract 704.01, Cheatham County, Tennessee",1372,68,4.96,1304,42.26
308,47021070402,"Census Tract 704.02, Cheatham County, Tennessee",3777,182,4.82,3595,38.18,"Census Tract 704.02, Cheatham County, Tennessee",4112,282,6.86,3830,38.6,"Census Tract 704.02, Cheatham County, Tennessee",3859,338,8.76,3521,38.25
309,47157008120,"Census Tract 81.20, Shelby County, Tennessee",1494,69,4.62,1425,25.01,"Census Tract 81.20, Shelby County, Tennessee",1591,57,3.58,1534,25.2,"Census Tract 81.20, Shelby County, Tennessee",1778,63,3.54,1715,25.06
310,47157008600,"Census Tract 86, Shelby County, Tennessee",3175,150,4.72,3025,24.68,"Census Tract 86, Shelby County, Tennessee",3048,149,4.89,2899,23.6,"Census Tract 86, Shelby County, Tennessee",3045,167,5.48,2878,21.96
311,47157008700,"Census Tract 87, Shelby County, Tennessee",2108,101,4.79,2007,23.8,"Census Tract 87, Shelby County, Tennessee",2280,112,4.91,2168,22.96,"Census Tract 87, Shelby County, Tennessee",2286,74,3.24,2212,26.03
312,47157021620,"Census Tract 216.20, Shelby County, Tennessee",1461,50,3.42,1411,28.24,"Census Tract 216.20, Shelby County, Tennessee",1328,0,0.0,1328,29.47,"Census Tract 216.20, Shelby County, Tennessee",1485,53,3.57,1432,27.34
313,47157021721,"Census Tract 217.21, Shelby County, Tennessee",2248,24,1.07,2224,24.4,"Census Tract 217.21, Shelby County, Tennessee",2372,44,1.85,2328,23.55,"Census Tract 217.21, Shelby County, Tennessee",2307,16,0.69,2291,23.59
314,47119010802,"Census Tract 108.02, Maury County, Tennessee",2683,26,0.97,2657,29.0,"Census Tract 108.02, Maury County, Tennessee",2843,17,0.6,2826,32.46,"Census Tract 108.02, Maury County, Tennessee",3619,44,1.22,3575,36.56
315,47119010201,"Census Tract 102.01, Maury County, Tennessee",2940,156,5.31,2784,41.47,"Census Tract 102.01, Maury County, Tennessee",3312,284,8.57,3028,38.96,"Census Tract 102.01, Maury County, Tennessee",3825,286,7.48,3539,37.9
316,47119011002,"Census Tract 110.02, Maury County, Tennessee",3028,34,1.12,2994,39.44,"Census Tract 110.02, Maury County, Tennessee",2903,0,0.0,2903,41.13,"Census Tract 110.02, Maury County, Tennessee",2879,27,0.94,2852,38.61
317,47119010302,"Census Tract 103.02, Maury County, Tennessee",1433,32,2.23,1401,37.39,"Census Tract 103.02, Maury County, Tennessee",1530,71,4.64,1459,36.36,"Census Tract 103.02, Maury County, Tennessee",1649,84,5.09,1565,36.37
318,47139950201,"Census Tract 9502.01, Polk County, Tennessee",905,79,8.73,826,32.3,"Census Tract 9502.01, Polk County, Tennessee",916,70,7.64,846,42.06,"Census Tract 9502.01, Polk County, Tennessee",934,79,8.46,855,41.32
319,47155080101,"Census Tract 801.01, Sevier County, Tennessee",1709,38,2.22,1671,33.19,"Census Tract 801.01, Sevier County, Tennessee",1774,0,0.0,1774,31.09,"Census Tract 801.01, Sevier County, Tennessee",1831,13,0.71,1818,28.4
320,47155080601,"Census Tract 806.01, Sevier County, Tennessee",2381,140,5.88,2241,27.27,"Census Tract 806.01, Sevier County, Tennessee",2290,165,7.21,2125,24.73,"Census Tract 806.01, Sevier County, Tennessee",2222,228,10.26,1994,26.93
321,47043060502,"Census Tract 605.02, Dickson County, Tennessee",1149,26,2.26,1123,35.61,"Census Tract 605.02, Dickson County, Tennessee",1103,27,2.45,1076,32.9,"Census Tract 605.02, Dickson County, Tennessee",1093,52,4.76,1041,31.43
322,47043060601,"Census Tract 606.01, Dickson County, Tennessee",1616,29,1.79,1587,36.37,"Census Tract 606.01, Dickson County, Tennessee",1792,36,2.01,1756,36.62,"Census Tract 606.01, Dickson County, Tennessee",1860,54,2.9,1806,34.84
323,47157008800,"Census Tract 88, Shelby County, Tennessee",3110,62,1.99,3048,33.92,"Census Tract 88, Shelby County, Tennessee",2942,17,0.58,2925,31.03,"Census Tract 88, Shelby County, Tennessee",2777,11,0.4,2766,26.88
324,47157008900,"Census Tract 89, Shelby County, Tennessee",1444,24,1.66,1420,28.06,"Census Tract 89, Shelby County, Tennessee",1593,66,4.14,1527,28.69,"Census Tract 89, Shelby County, Tennessee",1754,75,4.28,1679,26.86
325,47157009100,"Census Tract 91, Shelby County, Tennessee",1092,3,0.27,1089,29.77,"Census Tract 91, Shelby County, Tennessee",1033,9,0.87,1024,29.24,"Census Tract 91, Shelby County, Tennessee",886,0,0.0,886,32.45
326,47157021731,"Census Tract 217.31, Shelby County, Tennessee",1049,26,2.48,1023,28.48,"Census Tract 217.31, Shelby County, Tennessee",1140,12,1.05,1128,28.04,"Census Tract 217.31, Shelby County, Tennessee",1264,13,1.03,1251,27.38
327,47157021741,"Census Tract 217.41, Shelby County, Tennessee",3576,113,3.16,3463,29.93,"Census Tract 217.41, Shelby County, Tennessee",3337,136,4.08,3201,29.16,"Census Tract 217.41, Shelby County, Tennessee",3472,45,1.3,3427,25.92
328,47157021732,"Census Tract 217.32, Shelby County, Tennessee",3155,55,1.74,3100,26.38,"Census Tract 217.32, Shelby County, Tennessee",3016,0,0.0,3016,25.1,"Census Tract 217.32, Shelby County, Tennessee",3027,66,2.18,2961,26.22
329,47125100601,"Census Tract 1006.01, Montgomery County, Tennessee",868,39,4.49,829,32.26,"Census Tract 1006.01, Montgomery County, Tennessee",1001,43,4.3,958,25.65,"Census Tract 1006.01, Montgomery County, Tennessee",904,39,4.31,865,24.59
330,47125101902,"Census Tract 1019.02, Montgomery County, Tennessee",1244,35,2.81,1209,25.67,"Census Tract 1019.02, Montgomery County, Tennessee",1067,35,3.28,1032,26.88,"Census Tract 1019.02, Montgomery County, Tennessee",1114,46,4.13,1068,28.26
331,47125102006,"Census Tract 1020.06, Montgomery County, Tennessee",3114,15,0.48,3099,31.02,"Census Tract 1020.06, Montgomery County, Tennessee",3731,29,0.78,3702,34.39,"Census Tract 1020.06, Montgomery County, Tennessee",3945,156,3.95,3789,35.68
332,47125101307,"Census Tract 1013.07, Montgomery County, Tennessee",1113,30,2.7,1083,29.38,"Census Tract 1013.07, Montgomery County, Tennessee",1128,31,2.75,1097,29.81,"Census Tract 1013.07, Montgomery County, Tennessee",1186,13,1.1,1173,28.15
333,47155080102,"Census Tract 801.02, Sevier County, Tennessee",2867,158,5.51,2709,34.24,"Census Tract 801.02, Sevier County, Tennessee",3322,173,5.21,3149,32.22,"Census Tract 801.02, Sevier County, Tennessee",3310,107,3.23,3203,32.37
334,47155080602,"Census Tract 806.02, Sevier County, Tennessee",4517,87,1.93,4430,32.8,"Census Tract 806.02, Sevier County, Tennessee",4229,135,3.19,4094,33.18,"Census Tract 806.02, Sevier County, Tennessee",4597,143,3.11,4454,35.31
335,47125101202,"Census Tract 1012.02, Montgomery County, Tennessee",1447,27,1.87,1420,29.66,"Census Tract 1012.02, Montgomery County, Tennessee",1778,38,2.14,1740,27.9,"Census Tract 1012.02, Montgomery County, Tennessee",1923,30,1.56,1893,29.63
336,47125101303,"Census Tract 1013.03, Montgomery County, Tennessee",4967,50,1.01,4917,26.92,"Census Tract 1013.03, Montgomery County, Tennessee",4806,107,2.23,4699,27.58,"Census Tract 1013.03, Montgomery County, Tennessee",5253,105,2.0,5148,30.79
337,47125102005,"Census Tract 1020.05, Montgomery County, Tennessee",2428,60,2.47,2368,25.09,"Census Tract 1020.05, Montgomery County, Tennessee",2661,125,4.7,2536,27.13,"Census Tract 1020.05, Montgomery County, Tennessee",2679,97,3.62,2582,33.56
338,47125102003,"Census Tract 1020.03, Montgomery County, Tennessee",2823,79,2.8,2744,25.38,"Census Tract 1020.03, Montgomery County, Tennessee",3426,90,2.63,3336,27.91,"Census Tract 1020.03, Montgomery County, Tennessee",3664,142,3.88,3522,32.01
339,47157006700,"Census Tract 67, Shelby County, Tennessee",937,0,0.0,937,24.7,"Census Tract 67, Shelby County, Tennessee",911,0,0.0,911,24.76,"Census Tract 67, Shelby County, Tennessee",1107,36,3.25,1071,26.34
340,47157009300,"Census Tract 93, Shelby County, Tennessee",2026,116,5.73,1910,24.12,"Census Tract 93, Shelby County, Tennessee",2063,15,0.73,2048,23.28,"Census Tract 93, Shelby County, Tennessee",2254,25,1.11,2229,22.01
341,47157009400,"Census Tract 94, Shelby County, Tennessee",1894,57,3.01,1837,21.95,"Census Tract 94, Shelby County, Tennessee",1840,116,6.3,1724,22.52,"Census Tract 94, Shelby County, Tennessee",1818,120,6.6,1698,21.33
342,47071920400,"Census Tract 9204, Hardin County, Tennessee",1587,53,3.34,1534,21.44,"Census Tract 9204, Hardin County, Tennessee",1533,161,10.5,1372,21.07,"Census Tract 9204, Hardin County, Tennessee",1632,110,6.74,1522,18.33
343,47071920600,"Census Tract 9206, Hardin County, Tennessee",1311,64,4.88,1247,33.76,"Census Tract 9206, Hardin County, Tennessee",1289,119,9.23,1170,28.99,"Census Tract 9206, Hardin County, Tennessee",1119,130,11.62,989,31.28
344,47071920300,"Census Tract 9203, Hardin County, Tennessee",1600,25,1.56,1575,21.25,"Census Tract 9203, Hardin County, Tennessee",1617,61,3.77,1556,21.49,"Census Tract 9203, Hardin County, Tennessee",1611,56,3.48,1555,25.24
345,47071920500,"Census Tract 9205, Hardin County, Tennessee",1755,66,3.76,1689,27.99,"Census Tract 9205, Hardin County, Tennessee",2087,184,8.82,1903,33.7,"Census Tract 9205, Hardin County, Tennessee",2011,169,8.4,1842,34.41
346,47071920100,"Census Tract 9201, Hardin County, Tennessee",1509,95,6.3,1414,30.39,"Census Tract 9201, Hardin County, Tennessee",1579,103,6.52,1476,28.38,"Census Tract 9201, Hardin County, Tennessee",1588,126,7.93,1462,23.95
347,47071920200,"Census Tract 9202, Hardin County, Tennessee",1527,146,9.56,1381,32.25,"Census Tract 9202, Hardin County, Tennessee",1510,182,12.05,1328,35.73,"Census Tract 9202, Hardin County, Tennessee",1683,87,5.17,1596,36.3
348,47157009500,"Census Tract 95, Shelby County, Tennessee",3408,105,3.08,3303,23.17,"Census Tract 95, Shelby County, Tennessee",3212,130,4.05,3082,23.43,"Census Tract 95, Shelby County, Tennessee",3419,110,3.22,3309,23.49
349,47157009600,"Census Tract 96, Shelby County, Tennessee",2628,42,1.6,2586,18.83,"Census Tract 96, Shelby County, Tennessee",2535,33,1.3,2502,19.79,"Census Tract 96, Shelby County, Tennessee",2798,180,6.43,2618,20.12
350,47063101200,"Census Tract 1012, Hamblen County, Tennessee",2721,44,1.62,2677,27.84,"Census Tract 1012, Hamblen County, Tennessee",2949,40,1.36,2909,31.04,"Census Tract 1012, Hamblen County, Tennessee",2893,55,1.9,2838,25.55
351,47063100700,"Census Tract 1007, Hamblen County, Tennessee",2535,9,0.36,2526,27.26,"Census Tract 1007, Hamblen County, Tennessee",2454,29,1.18,2425,27.74,"Census Tract 1007, Hamblen County, Tennessee",2413,35,1.45,2378,31.3
352,47063100300,"Census Tract 1003, Hamblen County, Tennessee",986,36,3.65,950,28.44,"Census Tract 1003, Hamblen County, Tennessee",1138,18,1.58,1120,24.92,"Census Tract 1003, Hamblen County, Tennessee",1118,13,1.16,1105,21.62
353,47063100800,"Census Tract 1008, Hamblen County, Tennessee",1172,0,0.0,1172,24.12,"Census Tract 1008, Hamblen County, Tennessee",1254,0,0.0,1254,24.88,"Census Tract 1008, Hamblen County, Tennessee",1134,30,2.65,1104,29.69
354,47063100600,"Census Tract 1006, Hamblen County, Tennessee",2797,60,2.15,2737,27.18,"Census Tract 1006, Hamblen County, Tennessee",2963,146,4.93,2817,24.86,"Census Tract 1006, Hamblen County, Tennessee",3309,138,4.17,3171,25.29
355,47063100500,"Census Tract 1005, Hamblen County, Tennessee",953,46,4.83,907,29.95,"Census Tract 1005, Hamblen County, Tennessee",1104,37,3.35,1067,29.79,"Census Tract 1005, Hamblen County, Tennessee",1233,37,3.0,1196,23.62
356,47063101100,"Census Tract 1011, Hamblen County, Tennessee",2020,65,3.22,1955,26.96,"Census Tract 1011, Hamblen County, Tennessee",1991,82,4.12,1909,26.94,"Census Tract 1011, Hamblen County, Tennessee",2171,40,1.84,2131,26.6
357,47063101000,"Census Tract 1010, Hamblen County, Tennessee",2608,149,5.71,2459,26.21,"Census Tract 1010, Hamblen County, Tennessee",2432,206,8.47,2226,26.17,"Census Tract 1010, Hamblen County, Tennessee",2410,130,5.39,2280,24.01
358,47063100400,"Census Tract 1004, Hamblen County, Tennessee",2309,43,1.86,2266,30.3,"Census Tract 1004, Hamblen County, Tennessee",2596,36,1.39,2560,27.77,"Census Tract 1004, Hamblen County, Tennessee",2646,38,1.44,2608,30.47
359,47063100100,"Census Tract 1001, Hamblen County, Tennessee",2449,12,0.49,2437,27.57,"Census Tract 1001, Hamblen County, Tennessee",2666,74,2.78,2592,28.86,"Census Tract 1001, Hamblen County, Tennessee",2632,149,5.66,2483,29.94
360,47063100900,"Census Tract 1009, Hamblen County, Tennessee",2230,28,1.26,2202,30.76,"Census Tract 1009, Hamblen County, Tennessee",2287,54,2.36,2233,30.92,"Census Tract 1009, Hamblen County, Tennessee",2211,51,2.31,2160,27.84
361,47063100200,"Census Tract 1002, Hamblen County, Tennessee",2015,0,0.0,2015,24.83,"Census Tract 1002, Hamblen County, Tennessee",1930,15,0.78,1915,21.51,"Census Tract 1002, Hamblen County, Tennessee",1950,18,0.92,1932,18.99
362,47157021752,"Census Tract 217.52, Shelby County, Tennessee",2333,44,1.89,2289,32.95,"Census Tract 217.52, Shelby County, Tennessee",2457,19,0.77,2438,34.71,"Census Tract 217.52, Shelby County, Tennessee",2851,46,1.61,2805,30.97
363,47157021751,"Census Tract 217.51, Shelby County, Tennessee",3582,126,3.52,3456,29.74,"Census Tract 217.51, Shelby County, Tennessee",3461,110,3.18,3351,31.01,"Census Tract 217.51, Shelby County, Tennessee",3412,112,3.28,3300,32.39
364,47125100400,"Census Tract 1004, Montgomery County, Tennessee",1154,4,0.35,1150,28.14,"Census Tract 1004, Montgomery County, Tennessee",1179,45,3.82,1134,30.68,"Census Tract 1004, Montgomery County, Tennessee",1301,23,1.77,1278,27.72
365,47065010800,"Census Tract 108, Hamilton County, Tennessee",2346,64,2.73,2282,22.46,"Census Tract 108, Hamilton County, Tennessee",2208,73,3.31,2135,20.72,"Census Tract 108, Hamilton County, Tennessee",2080,80,3.85,2000,23.51
366,47065011447,"Census Tract 114.47, Hamilton County, Tennessee",4269,231,5.41,4038,28.66,"Census Tract 114.47, Hamilton County, Tennessee",4145,291,7.02,3854,29.7,"Census Tract 114.47, Hamilton County, Tennessee",4111,357,8.68,3754,28.05
367,47065980200,"Census Tract 9802, Hamilton County, Tennessee",0,0,,0,0.0,"Census Tract 9802, Hamilton County, Tennessee",0,0,,0,0.0,"Census Tract 9802, Hamilton County, Tennessee",0,0,,0,0.0
368,47065980100,"Census Tract 9801, Hamilton County, Tennessee",0,0,,0,0.0,"Census Tract 9801, Hamilton County, Tennessee",0,0,,0,0.0,"Census Tract 9801, Hamilton County, Tennessee",0,0,,0,0.0
369,47149040806,"Census Tract 408.06, Rutherford County, Tennessee",3567,65,1.82,3502,39.14,"Census Tract 408.06, Rutherford County, Tennessee",3577,166,4.64,3411,38.19,"Census Tract 408.06, Rutherford County, Tennessee",3705,133,3.59,3572,42.12
370,47149041102,"Census Tract 411.02, Rutherford County, Tennessee",1417,17,1.2,1400,29.6,"Census Tract 411.02, Rutherford County, Tennessee",1198,41,3.42,1157,35.11,"Census Tract 411.02, Rutherford County, Tennessee",1463,57,3.9,1406,30.52
371,47149041202,"Census Tract 412.02, Rutherford County, Tennessee",2192,26,1.19,2166,32.17,"Census Tract 412.02, Rutherford County, Tennessee",2212,62,2.8,2150,32.96,"Census Tract 412.02, Rutherford County, Tennessee",2314,150,6.48,2164,36.07
372,47149041401,"Census Tract 414.01, Rutherford County, Tennessee",2432,110,4.52,2322,29.95,"Census Tract 414.01, Rutherford County, Tennessee",2704,157,5.81,2547,31.15,"Census Tract 414.01, Rutherford County, Tennessee",2482,99,3.99,2383,31.12
373,47149040305,"Census Tract 403.05, Rutherford County, Tennessee",1022,84,8.22,938,31.98,"Census Tract 403.05, Rutherford County, Tennessee",1124,96,8.54,1028,33.34,"Census Tract 403.05, Rutherford County, Tennessee",1421,77,5.42,1344,30.82
374,47073050302,"Census Tract 503.02, Hawkins County, Tennessee",1475,35,2.37,1440,28.02,"Census Tract 503.02, Hawkins County, Tennessee",1420,37,2.61,1383,27.1,"Census Tract 503.02, Hawkins County, Tennessee",1410,45,3.19,1365,27.46
375,47149040105,"Census Tract 401.05, Rutherford County, Tennessee",2078,21,1.01,2057,36.85,"Census Tract 401.05, Rutherford County, Tennessee",2395,37,1.54,2358,40.62,"Census Tract 401.05, Rutherford County, Tennessee",2346,84,3.58,2262,39.92
376,47149040501,"Census Tract 405.01, Rutherford County, Tennessee",3662,124,3.39,3538,37.58,"Census Tract 405.01, Rutherford County, Tennessee",4027,208,5.17,3819,41.51,"Census Tract 405.01, Rutherford County, Tennessee",4310,381,8.84,3929,41.5
377,47149040808,"Census Tract 408.08, Rutherford County, Tennessee",3550,163,4.59,3387,38.2,"Census Tract 408.08, Rutherford County, Tennessee",4246,265,6.24,3981,33.66,"Census Tract 408.08, Rutherford County, Tennessee",4662,480,10.3,4182,33.54
378,47149040303,"Census Tract 403.03, Rutherford County, Tennessee",1008,22,2.18,986,35.58,"Census Tract 403.03, Rutherford County, Tennessee",1016,34,3.35,982,32.65,"Census Tract 403.03, Rutherford County, Tennessee",1191,31,2.6,1160,37.95
379,47149040502,"Census Tract 405.02, Rutherford County, Tennessee",3291,37,1.12,3254,34.79,"Census Tract 405.02, Rutherford County, Tennessee",3784,162,4.28,3622,33.1,"Census Tract 405.02, Rutherford County, Tennessee",4262,256,6.01,4006,35.85
380,47149041201,"Census Tract 412.01, Rutherford County, Tennessee",2468,126,5.11,2342,33.72,"Census Tract 412.01, Rutherford County, Tennessee",2712,162,5.97,2550,35.61,"Census Tract 412.01, Rutherford County, Tennessee",2803,194,6.92,2609,38.84
381,47149040809,"Census Tract 408.09, Rutherford County, Tennessee",2113,51,2.41,2062,35.01,"Census Tract 408.09, Rutherford County, Tennessee",2292,81,3.53,2211,37.19,"Census Tract 408.09, Rutherford County, Tennessee",2278,165,7.24,2113,40.71
382,47149041403,"Census Tract 414.03, Rutherford County, Tennessee",4215,74,1.76,4141,30.9,"Census Tract 414.03, Rutherford County, Tennessee",5037,106,2.1,4931,30.25,"Census Tract 414.03, Rutherford County, Tennessee",6003,211,3.51,5792,29.82
383,47149040304,"Census Tract 403.04, Rutherford County, Tennessee",1128,53,4.7,1075,38.26,"Census Tract 403.04, Rutherford County, Tennessee",1242,18,1.45,1224,34.89,"Census Tract 403.04, Rutherford County, Tennessee",1536,46,2.99,1490,38.26
384,47157009700,"Census Tract 97, Shelby County, Tennessee",1137,0,0.0,1137,24.78,"Census Tract 97, Shelby County, Tennessee",1170,25,2.14,1145,26.14,"Census Tract 97, Shelby County, Tennessee",1110,21,1.89,1089,26.73
385,47157009800,"Census Tract 98, Shelby County, Tennessee",1470,26,1.77,1444,23.13,"Census Tract 98, Shelby County, Tennessee",1341,21,1.57,1320,24.05,"Census Tract 98, Shelby County, Tennessee",1370,49,3.58,1321,24.92
386,47157010000,"Census Tract 100, Shelby County, Tennessee",2457,47,1.91,2410,26.19,"Census Tract 100, Shelby County, Tennessee",2673,61,2.28,2612,26.35,"Census Tract 100, Shelby County, Tennessee",2340,73,3.12,2267,26.06
387,47149040904,"Census Tract 409.04, Rutherford County, Tennessee",2329,105,4.51,2224,30.77,"Census Tract 409.04, Rutherford County, Tennessee",2473,42,1.7,2431,32.22,"Census Tract 409.04, Rutherford County, Tennessee",2367,81,3.42,2286,30.69
388,47149041402,"Census Tract 414.02, Rutherford County, Tennessee",3302,148,4.48,3154,32.56,"Census Tract 414.02, Rutherford County, Tennessee",3971,174,4.38,3797,32.32,"Census Tract 414.02, Rutherford County, Tennessee",4031,163,4.04,3868,35.91
389,47157010110,"Census Tract 101.10, Shelby County, Tennessee",2285,45,1.97,2240,25.56,"Census Tract 101.10, Shelby County, Tennessee",2035,0,0.0,2035,25.67,"Census Tract 101.10, Shelby County, Tennessee",2139,83,3.88,2056,26.05
390,47157021420,"Census Tract 214.20, Shelby County, Tennessee",1541,8,0.52,1533,22.74,"Census Tract 214.20, Shelby County, Tennessee",1395,30,2.15,1365,25.2,"Census Tract 214.20, Shelby County, Tennessee",1450,47,3.24,1403,24.62
391,47157021430,"Census Tract 214.30, Shelby County, Tennessee",2159,75,3.47,2084,24.79,"Census Tract 214.30, Shelby County, Tennessee",2249,122,5.42,2127,25.12,"Census Tract 214.30, Shelby County, Tennessee",2091,109,5.21,1982,23.55
392,47157021754,"Census Tract 217.54, Shelby County, Tennessee",2086,64,3.07,2022,26.88,"Census Tract 217.54, Shelby County, Tennessee",2139,104,4.86,2035,26.33,"Census Tract 217.54, Shelby County, Tennessee",2098,62,2.96,2036,26.77
393,47157021900,"Census Tract 219, Shelby County, Tennessee",2033,64,3.15,1969,25.22,"Census Tract 219, Shelby County, Tennessee",2236,51,2.28,2185,27.18,"Census Tract 219, Shelby County, Tennessee",2118,43,2.03,2075,26.75
394,47157021753,"Census Tract 217.53, Shelby County, Tennessee",1752,0,0.0,1752,26.17,"Census Tract 217.53, Shelby County, Tennessee",1523,0,0.0,1523,27.36,"Census Tract 217.53, Shelby County, Tennessee",1543,0,0.0,1543,27.61
395,47157006800,"Census Tract 68, Shelby County, Tennessee",749,59,7.88,690,26.51,"Census Tract 68, Shelby County, Tennessee",822,33,4.01,789,37.62,"Census Tract 68, Shelby County, Tennessee",794,27,3.4,767,40.54
396,47157006900,"Census Tract 69, Shelby County, Tennessee",944,90,9.53,854,26.57,"Census Tract 69, Shelby County, Tennessee",1019,58,5.69,961,26.24,"Census Tract 69, Shelby County, Tennessee",959,15,1.56,944,24.24
397,47157007000,"Census Tract 70, Shelby County, Tennessee",1597,77,4.82,1520,31.27,"Census Tract 70, Shelby County, Tennessee",1536,77,5.01,1459,33.68,"Census Tract 70, Shelby County, Tennessee",1353,62,4.58,1291,27.26
398,47157010210,"Census Tract 102.10, Shelby County, Tennessee",1930,21,1.09,1909,28.58,"Census Tract 102.10, Shelby County, Tennessee",2109,39,1.85,2070,25.87,"Census Tract 102.10, Shelby County, Tennessee",2281,19,0.83,2262,24.66
399,47157010610,"Census Tract 106.10, Shelby County, Tennessee",2994,54,1.8,2940,24.17,"Census Tract 106.10, Shelby County, Tennessee",2281,28,1.23,2253,25.07,"Census Tract 106.10, Shelby County, Tennessee",2621,27,1.03,2594,24.33
400,47157010620,"Census Tract 106.20, Shelby County, Tennessee",1387,25,1.8,1362,27.66,"Census Tract 106.20, Shelby County, Tennessee",1610,7,0.43,1603,28.43,"Census Tract 106.20, Shelby County, Tennessee",1614,64,3.97,1550,26.49
401,47093006003,"Census Tract 60.03, Knox County, Tennessee",2019,115,5.7,1904,29.01,"Census Tract 60.03, Knox County, Tennessee",2119,98,4.62,2021,30.12,"Census Tract 60.03, Knox County, Tennessee",2271,129,5.68,2142,29.76
402,47097050506,"Census Tract 505.06, Lauderdale County, Tennessee",913,45,4.93,868,33.74,"Census Tract 505.06, Lauderdale County, Tennessee",939,5,0.53,934,30.67,"Census Tract 505.06, Lauderdale County, Tennessee",933,3,0.32,930,27.26
403,47157007100,"Census Tract 71, Shelby County, Tennessee",1131,96,8.49,1035,23.66,"Census Tract 71, Shelby County, Tennessee",1278,64,5.01,1214,20.57,"Census Tract 71, Shelby County, Tennessee",1402,3,0.21,1399,23.29
404,47157007200,"Census Tract 72, Shelby County, Tennessee",1768,34,1.92,1734,20.78,"Census Tract 72, Shelby County, Tennessee",1892,32,1.69,1860,21.92,"Census Tract 72, Shelby County, Tennessee",1982,55,2.77,1927,22.97
405,47157010710,"Census Tract 107.10, Shelby County, Tennessee",2124,10,0.47,2114,23.92,"Census Tract 107.10, Shelby County, Tennessee",1891,39,2.06,1852,23.95,"Census Tract 107.10, Shelby County, Tennessee",1935,30,1.55,1905,26.65
406,47157010720,"Census Tract 107.20, Shelby County, Tennessee",1809,0,0.0,1809,26.58,"Census Tract 107.20, Shelby County, Tennessee",1827,23,1.26,1804,26.28,"Census Tract 107.20, Shelby County, Tennessee",1884,17,0.9,1867,24.4
407,47157010810,"Census Tract 108.10, Shelby County, Tennessee",2825,86,3.04,2739,22.93,"Census Tract 108.10, Shelby County, Tennessee",2801,70,2.5,2731,24.55,"Census Tract 108.10, Shelby County, Tennessee",2825,11,0.39,2814,24.61
408,47157010820,"Census Tract 108.20, Shelby County, Tennessee",2323,11,0.47,2312,22.89,"Census Tract 108.20, Shelby County, Tennessee",2163,36,1.66,2127,22.1,"Census Tract 108.20, Shelby County, Tennessee",2154,50,2.32,2104,20.7
409,47037013202,"Census Tract 132.02, Davidson County, Tennessee",1816,70,3.85,1746,23.35,"Census Tract 132.02, Davidson County, Tennessee",1887,73,3.87,1814,24.97,"Census Tract 132.02, Davidson County, Tennessee",2102,208,9.9,1894,27.87
410,47037013201,"Census Tract 132.01, Davidson County, Tennessee",1556,59,3.79,1497,28.18,"Census Tract 132.01, Davidson County, Tennessee",1631,116,7.11,1515,25.98,"Census Tract 132.01, Davidson County, Tennessee",1608,127,7.9,1481,24.41
411,47037018409,"Census Tract 184.09, Davidson County, Tennessee",2151,69,3.21,2082,31.01,"Census Tract 184.09, Davidson County, Tennessee",2214,142,6.41,2072,31.85,"Census Tract 184.09, Davidson County, Tennessee",2185,77,3.52,2108,29.77
412,47037018410,"Census Tract 184.10, Davidson County, Tennessee",1856,74,3.99,1782,28.33,"Census Tract 184.10, Davidson County, Tennessee",1860,133,7.15,1727,27.56,"Census Tract 184.10, Davidson County, Tennessee",2066,132,6.39,1934,29.95
413,47037015803,"Census Tract 158.03, Davidson County, Tennessee",1356,0,0.0,1356,27.62,"Census Tract 158.03, Davidson County, Tennessee",1835,0,0.0,1835,23.56,"Census Tract 158.03, Davidson County, Tennessee",1607,21,1.31,1586,26.39
414,47157011010,"Census Tract 110.10, Shelby County, Tennessee",1564,31,1.98,1533,25.27,"Census Tract 110.10, Shelby County, Tennessee",1482,7,0.47,1475,23.48,"Census Tract 110.10, Shelby County, Tennessee",1508,0,0.0,1508,23.49
415,47037015804,"Census Tract 158.04, Davidson County, Tennessee",2650,95,3.58,2555,25.1,"Census Tract 158.04, Davidson County, Tennessee",2926,123,4.2,2803,27.46,"Census Tract 158.04, Davidson County, Tennessee",2581,93,3.6,2488,27.31
416,47037015629,"Census Tract 156.29, Davidson County, Tennessee",3284,89,2.71,3195,30.7,"Census Tract 156.29, Davidson County, Tennessee",3829,0,0.0,3829,33.61,"Census Tract 156.29, Davidson County, Tennessee",4390,78,1.78,4312,34.3
417,47125101500,"Census Tract 1015, Montgomery County, Tennessee",3092,68,2.2,3024,36.03,"Census Tract 1015, Montgomery County, Tennessee",3400,69,2.03,3331,38.96,"Census Tract 1015, Montgomery County, Tennessee",3166,72,2.27,3094,38.95
418,47125101103,"Census Tract 1011.03, Montgomery County, Tennessee",1008,38,3.77,970,38.67,"Census Tract 1011.03, Montgomery County, Tennessee",1061,32,3.02,1029,38.43,"Census Tract 1011.03, Montgomery County, Tennessee",1149,36,3.13,1113,41.14
419,47125100900,"Census Tract 1009, Montgomery County, Tennessee",886,10,1.13,876,26.67,"Census Tract 1009, Montgomery County, Tennessee",1354,12,0.89,1342,33.35,"Census Tract 1009, Montgomery County, Tennessee",1365,0,0.0,1365,39.61
420,47125101102,"Census Tract 1011.02, Montgomery County, Tennessee",3080,55,1.79,3025,28.66,"Census Tract 1011.02, Montgomery County, Tennessee",3259,57,1.75,3202,30.17,"Census Tract 1011.02, Montgomery County, Tennessee",3733,14,0.38,3719,33.93
421,47125101802,"Census Tract 1018.02, Montgomery County, Tennessee",4605,175,3.8,4430,35.2,"Census Tract 1018.02, Montgomery County, Tennessee",5107,213,4.17,4894,34.29,"Census Tract 1018.02, Montgomery County, Tennessee",5542,183,3.3,5359,35.18
422,47125101600,"Census Tract 1016, Montgomery County, Tennessee",2275,100,4.4,2175,34.77,"Census Tract 1016, Montgomery County, Tennessee",2619,42,1.6,2577,35.88,"Census Tract 1016, Montgomery County, Tennessee",2568,79,3.08,2489,34.32
423,47125101700,"Census Tract 1017, Montgomery County, Tennessee",3364,44,1.31,3320,46.3,"Census Tract 1017, Montgomery County, Tennessee",3604,102,2.83,3502,44.22,"Census Tract 1017, Montgomery County, Tennessee",3405,134,3.94,3271,41.62
424,47125101400,"Census Tract 1014, Montgomery County, Tennessee",2727,14,0.51,2713,13.8,"Census Tract 1014, Montgomery County, Tennessee",2997,47,1.57,2950,14.04,"Census Tract 1014, Montgomery County, Tennessee",3067,50,1.63,3017,14.91
425,47125100100,"Census Tract 1001, Montgomery County, Tennessee",454,4,0.88,450,29.94,"Census Tract 1001, Montgomery County, Tennessee",459,4,0.87,455,29.58,"Census Tract 1001, Montgomery County, Tennessee",442,0,0.0,442,29.21
426,47125100500,"Census Tract 1005, Montgomery County, Tennessee",2441,0,0.0,2441,31.13,"Census Tract 1005, Montgomery County, Tennessee",2325,9,0.39,2316,30.87,"Census Tract 1005, Montgomery County, Tennessee",1817,9,0.5,1808,27.99
427,47157011020,"Census Tract 110.20, Shelby County, Tennessee",604,4,0.66,600,28.11,"Census Tract 110.20, Shelby County, Tennessee",629,0,0.0,629,26.67,"Census Tract 110.20, Shelby County, Tennessee",619,0,0.0,619,24.55
428,47157020400,"Census Tract 204, Shelby County, Tennessee",666,7,1.05,659,12.41,"Census Tract 204, Shelby County, Tennessee",636,7,1.1,629,10.89,"Census Tract 204, Shelby County, Tennessee",583,31,5.32,552,13.22
429,47037015626,"Census Tract 156.26, Davidson County, Tennessee",4017,48,1.19,3969,31.41,"Census Tract 156.26, Davidson County, Tennessee",3700,88,2.38,3612,31.61,"Census Tract 156.26, Davidson County, Tennessee",3999,31,0.78,3968,36.29
430,47037015628,"Census Tract 156.28, Davidson County, Tennessee",2143,88,4.11,2055,29.75,"Census Tract 156.28, Davidson County, Tennessee",2169,116,5.35,2053,33.37,"Census Tract 156.28, Davidson County, Tennessee",2189,127,5.8,2062,33.3
431,47165021106,"Census Tract 211.06, Sumner County, Tennessee",2119,53,2.5,2066,27.81,"Census Tract 211.06, Sumner County, Tennessee",2035,87,4.28,1948,29.13,"Census Tract 211.06, Sumner County, Tennessee",2018,112,5.55,1906,28.03
432,47093005401,"Census Tract 54.01, Knox County, Tennessee",1452,40,2.75,1412,29.56,"Census Tract 54.01, Knox County, Tennessee",1711,65,3.8,1646,29.81,"Census Tract 54.01, Knox County, Tennessee",1650,102,6.18,1548,28.46
433,47093005604,"Census Tract 56.04, Knox County, Tennessee",1232,75,6.09,1157,24.3,"Census Tract 56.04, Knox County, Tennessee",1104,63,5.71,1041,24.71,"Census Tract 56.04, Knox County, Tennessee",1251,129,10.31,1122,25.81
434,47093004403,"Census Tract 44.03, Knox County, Tennessee",2923,58,1.98,2865,22.1,"Census Tract 44.03, Knox County, Tennessee",2753,167,6.07,2586,21.85,"Census Tract 44.03, Knox County, Tennessee",2827,163,5.77,2664,22.25
435,47093005710,"Census Tract 57.10, Knox County, Tennessee",1055,38,3.6,1017,25.86,"Census Tract 57.10, Knox County, Tennessee",1143,90,7.87,1053,28.43,"Census Tract 57.10, Knox County, Tennessee",1141,124,10.87,1017,28.95
436,47093006208,"Census Tract 62.08, Knox County, Tennessee",2437,0,0.0,2437,33.98,"Census Tract 62.08, Knox County, Tennessee",2152,20,0.93,2132,30.32,"Census Tract 62.08, Knox County, Tennessee",2475,127,5.13,2348,34.49
437,47093005812,"Census Tract 58.12, Knox County, Tennessee",2421,186,7.68,2235,32.89,"Census Tract 58.12, Knox County, Tennessee",2935,292,9.95,2643,30.51,"Census Tract 58.12, Knox County, Tennessee",3170,309,9.75,2861,31.41
438,47093004611,"Census Tract 46.11, Knox County, Tennessee",1960,99,5.05,1861,26.45,"Census Tract 46.11, Knox County, Tennessee",2007,161,8.02,1846,26.67,"Census Tract 46.11, Knox County, Tennessee",2450,227,9.27,2223,27.66
439,47093005904,"Census Tract 59.04, Knox County, Tennessee",2314,160,6.91,2154,20.72,"Census Tract 59.04, Knox County, Tennessee",2910,221,7.59,2689,24.19,"Census Tract 59.04, Knox County, Tennessee",3172,197,6.21,2975,26.58
440,47093005808,"Census Tract 58.08, Knox County, Tennessee",2684,192,7.15,2492,24.67,"Census Tract 58.08, Knox County, Tennessee",2752,55,2.0,2697,25.07,"Census Tract 58.08, Knox County, Tennessee",2757,104,3.77,2653,23.84
441,47093006205,"Census Tract 62.05, Knox County, Tennessee",2100,73,3.48,2027,29.54,"Census Tract 62.05, Knox County, Tennessee",2055,140,6.81,1915,29.11,"Census Tract 62.05, Knox County, Tennessee",2059,163,7.92,1896,30.22
442,47093005906,"Census Tract 59.06, Knox County, Tennessee",879,50,5.69,829,29.37,"Census Tract 59.06, Knox County, Tennessee",911,42,4.61,869,31.66,"Census Tract 59.06, Knox County, Tennessee",991,72,7.27,919,31.04
443,47093005712,"Census Tract 57.12, Knox County, Tennessee",3917,164,4.19,3753,25.82,"Census Tract 57.12, Knox County, Tennessee",4138,320,7.73,3818,26.87,"Census Tract 57.12, Knox County, Tennessee",4365,334,7.65,4031,26.73
444,47093006001,"Census Tract 60.01, Knox County, Tennessee",1440,44,3.06,1396,25.0,"Census Tract 60.01, Knox County, Tennessee",1861,65,3.49,1796,24.35,"Census Tract 60.01, Knox County, Tennessee",2464,28,1.14,2436,23.72
445,47093006900,"Census Tract 69, Knox County, Tennessee",3317,139,4.19,3178,17.17,"Census Tract 69, Knox County, Tennessee",3754,295,7.86,3459,18.37,"Census Tract 69, Knox County, Tennessee",4043,201,4.97,3842,20.05
446,47093005811,"Census Tract 58.11, Knox County, Tennessee",1256,23,1.83,1233,29.6,"Census Tract 58.11, Knox County, Tennessee",1350,51,3.78,1299,30.19,"Census Tract 58.11, Knox County, Tennessee",1590,107,6.73,1483,30.2
447,47093006206,"Census Tract 62.06, Knox County, Tennessee",2523,95,3.77,2428,29.23,"Census Tract 62.06, Knox County, Tennessee",2353,138,5.86,2215,28.83,"Census Tract 62.06, Knox County, Tennessee",2479,102,4.11,2377,29.75
448,47093005706,"Census Tract 57.06, Knox County, Tennessee",2138,161,7.53,1977,21.94,"Census Tract 57.06, Knox County, Tennessee",2126,140,6.59,1986,23.54,"Census Tract 57.06, Knox County, Tennessee",2071,211,10.19,1860,23.86
449,47011011500,"Census Tract 115, Bradley County, Tennessee",3446,302,8.76,3144,30.46,"Census Tract 115, Bradley County, Tennessee",4049,288,7.11,3761,27.69,"Census Tract 115, Bradley County, Tennessee",4227,252,5.96,3975,27.52
450,47093007000,"Census Tract 70, Knox County, Tennessee",924,9,0.97,915,26.07,"Census Tract 70, Knox County, Tennessee",1082,10,0.92,1072,24.83,"Census Tract 70, Knox County, Tennessee",1286,19,1.48,1267,25.06
451,47157020511,"Census Tract 205.11, Shelby County, Tennessee",966,6,0.62,960,24.92,"Census Tract 205.11, Shelby County, Tennessee",1109,17,1.53,1092,24.74,"Census Tract 205.11, Shelby County, Tennessee",1176,16,1.36,1160,23.94
452,47157020541,"Census Tract 205.41, Shelby County, Tennessee",2495,35,1.4,2460,27.85,"Census Tract 205.41, Shelby County, Tennessee",2538,55,2.17,2483,28.35,"Census Tract 205.41, Shelby County, Tennessee",2180,16,0.73,2164,28.8
453,47157020542,"Census Tract 205.42, Shelby County, Tennessee",2185,0,0.0,2185,23.57,"Census Tract 205.42, Shelby County, Tennessee",2535,43,1.7,2492,24.27,"Census Tract 205.42, Shelby County, Tennessee",2683,31,1.16,2652,29.83
454,47153060200,"Census Tract 602, Sequatchie County, Tennessee",1772,158,8.92,1614,41.88,"Census Tract 602, Sequatchie County, Tennessee",1953,166,8.5,1787,40.87,"Census Tract 602, Sequatchie County, Tennessee",1883,52,2.76,1831,43.07
455,47011010200,"Census Tract 102, Bradley County, Tennessee",2407,33,1.37,2374,21.62,"Census Tract 102, Bradley County, Tennessee",2974,40,1.34,2934,21.06,"Census Tract 102, Bradley County, Tennessee",2918,42,1.44,2876,21.75
456,47011010600,"Census Tract 106, Bradley County, Tennessee",1196,69,5.77,1127,19.25,"Census Tract 106, Bradley County, Tennessee",1363,68,4.99,1295,19.59,"Census Tract 106, Bradley County, Tennessee",1652,83,5.02,1569,21.66
457,47011011201,"Census Tract 112.01, Bradley County, Tennessee",2819,189,6.7,2630,31.63,"Census Tract 112.01, Bradley County, Tennessee",2840,139,4.89,2701,26.56,"Census Tract 112.01, Bradley County, Tennessee",3057,187,6.12,2870,24.95
458,47011011202,"Census Tract 112.02, Bradley County, Tennessee",3546,122,3.44,3424,31.43,"Census Tract 112.02, Bradley County, Tennessee",4249,248,5.84,4001,28.21,"Census Tract 112.02, Bradley County, Tennessee",4612,243,5.27,4369,27.27
459,47011010300,"Census Tract 103, Bradley County, Tennessee",1215,89,7.33,1126,29.59,"Census Tract 103, Bradley County, Tennessee",1034,42,4.06,992,27.98,"Census Tract 103, Bradley County, Tennessee",1154,16,1.39,1138,29.03
460,47011010100,"Census Tract 101, Bradley County, Tennessee",2042,36,1.76,2006,26.14,"Census Tract 101, Bradley County, Tennessee",2317,150,6.47,2167,23.66,"Census Tract 101, Bradley County, Tennessee",2458,181,7.36,2277,20.78
461,47011011300,"Census Tract 113, Bradley County, Tennessee",3483,163,4.68,3320,32.18,"Census Tract 113, Bradley County, Tennessee",3463,165,4.76,3298,34.35,"Census Tract 113, Bradley County, Tennessee",3614,58,1.6,3556,30.53
462,47011011000,"Census Tract 110, Bradley County, Tennessee",2466,24,0.97,2442,25.53,"Census Tract 110, Bradley County, Tennessee",2653,61,2.3,2592,21.27,"Census Tract 110, Bradley County, Tennessee",2694,101,3.75,2593,23.84
463,47011011100,"Census Tract 111, Bradley County, Tennessee",4431,119,2.69,4312,26.13,"Census Tract 111, Bradley County, Tennessee",4822,113,2.34,4709,26.47,"Census Tract 111, Bradley County, Tennessee",5150,136,2.64,5014,27.79
464,47011010500,"Census Tract 105, Bradley County, Tennessee",1734,105,6.06,1629,21.41,"Census Tract 105, Bradley County, Tennessee",1684,52,3.09,1632,20.02,"Census Tract 105, Bradley County, Tennessee",1750,40,2.29,1710,18.72
465,47011010900,"Census Tract 109, Bradley County, Tennessee",1347,59,4.38,1288,23.94,"Census Tract 109, Bradley County, Tennessee",1172,22,1.88,1150,24.73,"Census Tract 109, Bradley County, Tennessee",1120,18,1.61,1102,25.12
466,47011010700,"Census Tract 107, Bradley County, Tennessee",1635,33,2.02,1602,21.82,"Census Tract 107, Bradley County, Tennessee",1634,42,2.57,1592,20.57,"Census Tract 107, Bradley County, Tennessee",1826,33,1.81,1793,22.03
467,47167040100,"Census Tract 401, Tipton County, Tennessee",1981,49,2.47,1932,44.98,"Census Tract 401, Tipton County, Tennessee",1937,48,2.48,1889,41.05,"Census Tract 401, Tipton County, Tennessee",2073,36,1.74,2037,43.73
468,47167040400,"Census Tract 404, Tipton County, Tennessee",1441,53,3.68,1388,41.88,"Census Tract 404, Tipton County, Tennessee",1424,34,2.39,1390,35.17,"Census Tract 404, Tipton County, Tennessee",1315,43,3.27,1272,42.66
469,47167041000,"Census Tract 410, Tipton County, Tennessee",1102,12,1.09,1090,43.39,"Census Tract 410, Tipton County, Tennessee",962,8,0.83,954,43.04,"Census Tract 410, Tipton County, Tennessee",982,22,2.24,960,39.79
470,47167040900,"Census Tract 409, Tipton County, Tennessee",768,0,0.0,768,35.02,"Census Tract 409, Tipton County, Tennessee",657,14,2.13,643,39.34,"Census Tract 409, Tipton County, Tennessee",738,38,5.15,700,35.39
471,47167040500,"Census Tract 405, Tipton County, Tennessee",3332,54,1.62,3278,44.83,"Census Tract 405, Tipton County, Tennessee",3127,65,2.08,3062,47.13,"Census Tract 405, Tipton County, Tennessee",2831,8,0.28,2823,41.38
472,47167040200,"Census Tract 402, Tipton County, Tennessee",759,6,0.79,753,47.45,"Census Tract 402, Tipton County, Tennessee",735,7,0.95,728,47.77,"Census Tract 402, Tipton County, Tennessee",748,14,1.87,734,50.25
473,47165020204,"Census Tract 202.04, Sumner County, Tennessee",1563,58,3.71,1505,35.78,"Census Tract 202.04, Sumner County, Tennessee",1569,55,3.51,1514,39.06,"Census Tract 202.04, Sumner County, Tennessee",1834,76,4.14,1758,37.73
474,47157006500,"Census Tract 65, Shelby County, Tennessee",757,0,0.0,757,23.93,"Census Tract 65, Shelby County, Tennessee",850,25,2.94,825,24.02,"Census Tract 65, Shelby County, Tennessee",889,21,2.36,868,23.79
475,47157980200,"Census Tract 9802, Shelby County, Tennessee",0,0,,0,0.0,"Census Tract 9802, Shelby County, Tennessee",0,0,,0,0.0,"Census Tract 9802, Shelby County, Tennessee",0,0,,0,0.0
476,47169090100,"Census Tract 901, Trousdale County, Tennessee",2117,30,1.42,2087,40.49,"Census Tract 901, Trousdale County, Tennessee",2543,103,4.05,2440,40.79,"Census Tract 901, Trousdale County, Tennessee",3160,162,5.13,2998,45.23
477,47169090200,"Census Tract 902, Trousdale County, Tennessee",1254,29,2.31,1225,29.42,"Census Tract 902, Trousdale County, Tennessee",1206,80,6.63,1126,29.16,"Census Tract 902, Trousdale County, Tennessee",1383,40,2.89,1343,41.46
478,47165020503,"Census Tract 205.03, Sumner County, Tennessee",962,10,1.04,952,29.41,"Census Tract 205.03, Sumner County, Tennessee",1010,30,2.97,980,35.17,"Census Tract 205.03, Sumner County, Tennessee",1151,36,3.13,1115,35.45
479,47165020101,"Census Tract 201.01, Sumner County, Tennessee",1593,78,4.9,1515,39.42,"Census Tract 201.01, Sumner County, Tennessee",1688,55,3.26,1633,36.1,"Census Tract 201.01, Sumner County, Tennessee",1730,60,3.47,1670,38.54
480,47165020602,"Census Tract 206.02, Sumner County, Tennessee",2415,35,1.45,2380,36.22,"Census Tract 206.02, Sumner County, Tennessee",2467,80,3.24,2387,35.4,"Census Tract 206.02, Sumner County, Tennessee",2235,77,3.45,2158,36.9
481,47165020203,"Census Tract 202.03, Sumner County, Tennessee",1211,9,0.74,1202,37.03,"Census Tract 202.03, Sumner County, Tennessee",1180,46,3.9,1134,36.55,"Census Tract 202.03, Sumner County, Tennessee",1225,63,5.14,1162,44.46
482,47165020207,"Census Tract 202.07, Sumner County, Tennessee",565,7,1.24,558,38.54,"Census Tract 202.07, Sumner County, Tennessee",704,40,5.68,664,36.65,"Census Tract 202.07, Sumner County, Tennessee",905,44,4.86,861,34.52
483,47165020206,"Census Tract 202.06, Sumner County, Tennessee",458,27,5.9,431,32.75,"Census Tract 202.06, Sumner County, Tennessee",522,27,5.17,495,28.41,"Census Tract 202.06, Sumner County, Tennessee",616,52,8.44,564,38.01
484,47165020404,"Census Tract 204.04, Sumner County, Tennessee",951,65,6.83,886,34.87,"Census Tract 204.04, Sumner County, Tennessee",1001,70,6.99,931,35.38,"Census Tract 204.04, Sumner County, Tennessee",941,41,4.36,900,37.92
485,47165021005,"Census Tract 210.05, Sumner County, Tennessee",3066,75,2.45,2991,34.99,"Census Tract 210.05, Sumner County, Tennessee",3167,161,5.08,3006,33.41,"Census Tract 210.05, Sumner County, Tennessee",3203,223,6.96,2980,31.54
486,47165021004,"Census Tract 210.04, Sumner County, Tennessee",2202,44,2.0,2158,33.52,"Census Tract 210.04, Sumner County, Tennessee",2217,46,2.07,2171,32.86,"Census Tract 210.04, Sumner County, Tennessee",2750,68,2.47,2682,33.62
487,47165020903,"Census Tract 209.03, Sumner County, Tennessee",1775,109,6.14,1666,27.35,"Census Tract 209.03, Sumner County, Tennessee",2012,130,6.46,1882,28.81,"Census Tract 209.03, Sumner County, Tennessee",2094,140,6.69,1954,33.01
488,47165021107,"Census Tract 211.07, Sumner County, Tennessee",2486,115,4.63,2371,34.26,"Census Tract 211.07, Sumner County, Tennessee",2504,135,5.39,2369,37.0,"Census Tract 211.07, Sumner County, Tennessee",2801,225,8.03,2576,39.72
489,47165021008,"Census Tract 210.08, Sumner County, Tennessee",2079,47,2.26,2032,32.07,"Census Tract 210.08, Sumner County, Tennessee",2648,146,5.51,2502,37.92,"Census Tract 210.08, Sumner County, Tennessee",3172,248,7.82,2924,41.2
490,47165020405,"Census Tract 204.05, Sumner County, Tennessee",809,17,2.1,792,43.6,"Census Tract 204.05, Sumner County, Tennessee",858,7,0.82,851,43.74,"Census Tract 204.05, Sumner County, Tennessee",1159,58,5.0,1101,41.46
491,47065011203,"Census Tract 112.03, Hamilton County, Tennessee",3179,176,5.54,3003,26.79,"Census Tract 112.03, Hamilton County, Tennessee",3640,273,7.5,3367,23.16,"Census Tract 112.03, Hamilton County, Tennessee",3545,415,11.71,3130,22.21
492,47165020502,"Census Tract 205.02, Sumner County, Tennessee",2068,110,5.32,1958,37.09,"Census Tract 205.02, Sumner County, Tennessee",2547,186,7.3,2361,34.63,"Census Tract 205.02, Sumner County, Tennessee",3181,247,7.76,2934,37.88
493,47165020603,"Census Tract 206.03, Sumner County, Tennessee",1948,102,5.24,1846,39.45,"Census Tract 206.03, Sumner County, Tennessee",1505,52,3.46,1453,36.95,"Census Tract 206.03, Sumner County, Tennessee",1748,87,4.98,1661,40.94
494,47101970200,"Census Tract 9702, Lewis County, Tennessee",2870,57,1.99,2813,30.57,"Census Tract 9702, Lewis County, Tennessee",2927,98,3.35,2829,29.31,"Census Tract 9702, Lewis County, Tennessee",3027,82,2.71,2945,27.0
495,47101970100,"Census Tract 9701, Lewis County, Tennessee",1898,119,6.27,1779,40.1,"Census Tract 9701, Lewis County, Tennessee",1816,114,6.28,1702,37.25,"Census Tract 9701, Lewis County, Tennessee",1765,113,6.4,1652,38.76
496,47127930200,"Census Tract 9302, Moore County, Tennessee",1218,47,3.86,1171,36.69,"Census Tract 9302, Moore County, Tennessee",1132,83,7.33,1049,33.84,"Census Tract 9302, Moore County, Tennessee",1086,81,7.46,1005,32.66
497,47065011444,"Census Tract 114.44, Hamilton County, Tennessee",1179,10,0.85,1169,22.8,"Census Tract 114.44, Hamilton County, Tennessee",1243,9,0.72,1234,24.35,"Census Tract 114.44, Hamilton County, Tennessee",1471,0,0.0,1471,24.38
498,47065000600,"Census Tract 6, Hamilton County, Tennessee",1816,223,12.28,1593,18.18,"Census Tract 6, Hamilton County, Tennessee",1836,192,10.46,1644,19.99,"Census Tract 6, Hamilton County, Tennessee",1897,198,10.44,1699,20.18
499,47065010304,"Census Tract 103.04, Hamilton County, Tennessee",2705,179,6.62,2526,30.94,"Census Tract 103.04, Hamilton County, Tennessee",2363,168,7.11,2195,32.67,"Census Tract 103.04, Hamilton County, Tennessee",2416,188,7.78,2228,31.82
500,47065010201,"Census Tract 102.01, Hamilton County, Tennessee",1739,86,4.95,1653,34.52,"Census Tract 102.01, Hamilton County, Tennessee",1632,74,4.53,1558,32.35,"Census Tract 102.01, Hamilton County, Tennessee",1602,96,5.99,1506,36.97
501,47065010434,"Census Tract 104.34, Hamilton County, Tennessee",1131,0,0.0,1131,23.35,"Census Tract 104.34, Hamilton County, Tennessee",898,6,0.67,892,25.69,"Census Tract 104.34, Hamilton County, Tennessee",969,17,1.75,952,28.04
502,47065010202,"Census Tract 102.02, Hamilton County, Tennessee",2097,49,2.34,2048,43.65,"Census Tract 102.02, Hamilton County, Tennessee",1855,45,2.43,1810,42.44,"Census Tract 102.02, Hamilton County, Tennessee",1821,58,3.19,1763,41.17
503,47065011323,"Census Tract 113.23, Hamilton County, Tennessee",2559,83,3.24,2476,24.34,"Census Tract 113.23, Hamilton County, Tennessee",2741,99,3.61,2642,26.19,"Census Tract 113.23, Hamilton County, Tennessee",3043,148,4.86,2895,28.46
504,47065012400,"Census Tract 124, Hamilton County, Tennessee",2364,132,5.58,2232,17.57,"Census Tract 124, Hamilton County, Tennessee",2577,118,4.58,2459,16.12,"Census Tract 124, Hamilton County, Tennessee",3006,155,5.16,2851,16.91
505,47165020403,"Census Tract 204.03, Sumner County, Tennessee",821,39,4.75,782,34.35,"Census Tract 204.03, Sumner County, Tennessee",986,31,3.14,955,34.2,"Census Tract 204.03, Sumner County, Tennessee",1058,59,5.58,999,36.05
506,47165021105,"Census Tract 211.05, Sumner County, Tennessee",4032,98,2.43,3934,29.34,"Census Tract 211.05, Sumner County, Tennessee",4192,149,3.55,4043,29.47,"Census Tract 211.05, Sumner County, Tennessee",3783,257,6.79,3526,30.9
507,47165021204,"Census Tract 212.04, Sumner County, Tennessee",3788,207,5.46,3581,31.49,"Census Tract 212.04, Sumner County, Tennessee",3798,280,7.37,3518,32.87,"Census Tract 212.04, Sumner County, Tennessee",3782,196,5.18,3586,38.03
508,47165021007,"Census Tract 210.07, Sumner County, Tennessee",1305,130,9.96,1175,35.4,"Census Tract 210.07, Sumner County, Tennessee",1436,170,11.84,1266,37.41,"Census Tract 210.07, Sumner County, Tennessee",1599,175,10.94,1424,38.06
509,47165020102,"Census Tract 201.02, Sumner County, Tennessee",1838,40,2.18,1798,41.86,"Census Tract 201.02, Sumner County, Tennessee",2056,65,3.16,1991,43.19,"Census Tract 201.02, Sumner County, Tennessee",2123,100,4.71,2023,41.95
510,47165020407,"Census Tract 204.07, Sumner County, Tennessee",2254,38,1.69,2216,33.88,"Census Tract 204.07, Sumner County, Tennessee",2477,12,0.48,2465,34.95,"Census Tract 204.07, Sumner County, Tennessee",2605,56,2.15,2549,39.81
511,47165020601,"Census Tract 206.01, Sumner County, Tennessee",1379,66,4.79,1313,34.88,"Census Tract 206.01, Sumner County, Tennessee",1589,131,8.24,1458,32.01,"Census Tract 206.01, Sumner County, Tennessee",1654,116,7.01,1538,35.5
512,47165020209,"Census Tract 202.09, Sumner County, Tennessee",886,6,0.68,880,38.61,"Census Tract 202.09, Sumner County, Tennessee",966,12,1.24,954,43.33,"Census Tract 202.09, Sumner County, Tennessee",901,30,3.33,871,43.89
513,47165020208,"Census Tract 202.08, Sumner County, Tennessee",1037,22,2.12,1015,32.14,"Census Tract 202.08, Sumner County, Tennessee",1231,42,3.41,1189,36.1,"Census Tract 202.08, Sumner County, Tennessee",1255,45,3.59,1210,36.78
514,47165020205,"Census Tract 202.05, Sumner County, Tennessee",1603,15,0.94,1588,36.96,"Census Tract 202.05, Sumner County, Tennessee",1666,20,1.2,1646,39.08,"Census Tract 202.05, Sumner County, Tennessee",1606,17,1.06,1589,42.07
515,47149040600,"Census Tract 406, Rutherford County, Tennessee",2342,85,3.63,2257,41.63,"Census Tract 406, Rutherford County, Tennessee",2542,159,6.25,2383,38.67,"Census Tract 406, Rutherford County, Tennessee",2616,186,7.11,2430,37.97
516,47165021006,"Census Tract 210.06, Sumner County, Tennessee",1554,75,4.83,1479,40.74,"Census Tract 210.06, Sumner County, Tennessee",1752,148,8.45,1604,42.43,"Census Tract 210.06, Sumner County, Tennessee",1916,124,6.47,1792,44.83
517,47165020406,"Census Tract 204.06, Sumner County, Tennessee",1595,138,8.65,1457,43.02,"Census Tract 204.06, Sumner County, Tennessee",1898,109,5.74,1789,46.55,"Census Tract 204.06, Sumner County, Tennessee",1796,72,4.01,1724,46.34
518,47117955200,"Census Tract 9552, Marshall County, Tennessee",2443,32,1.31,2411,31.11,"Census Tract 9552, Marshall County, Tennessee",2710,37,1.37,2673,33.56,"Census Tract 9552, Marshall County, Tennessee",2865,53,1.85,2812,35.75
519,47117955100,"Census Tract 9551, Marshall County, Tennessee",2498,27,1.08,2471,35.07,"Census Tract 9551, Marshall County, Tennessee",2273,24,1.06,2249,35.76,"Census Tract 9551, Marshall County, Tennessee",2551,0,0.0,2551,38.53
520,47117955000,"Census Tract 9550, Marshall County, Tennessee",3000,78,2.6,2922,52.85,"Census Tract 9550, Marshall County, Tennessee",3330,144,4.32,3186,49.86,"Census Tract 9550, Marshall County, Tennessee",3642,170,4.67,3472,44.42
521,47117955300,"Census Tract 9553, Marshall County, Tennessee",1595,0,0.0,1595,22.86,"Census Tract 9553, Marshall County, Tennessee",1540,21,1.36,1519,29.48,"Census Tract 9553, Marshall County, Tennessee",1616,72,4.46,1544,31.28
522,47117955500,"Census Tract 9555, Marshall County, Tennessee",1980,36,1.82,1944,38.44,"Census Tract 9555, Marshall County, Tennessee",1997,44,2.2,1953,36.2,"Census Tract 9555, Marshall County, Tennessee",2116,111,5.25,2005,36.01
523,47019071500,"Census Tract 715, Carter County, Tennessee",694,44,6.34,650,35.32,"Census Tract 715, Carter County, Tennessee",681,39,5.73,642,35.38,"Census Tract 715, Carter County, Tennessee",673,0,0.0,673,33.38
524,47187050800,"Census Tract 508, Williamson County, Tennessee",2473,103,4.16,2370,29.19,"Census Tract 508, Williamson County, Tennessee",2645,99,3.74,2546,29.25,"Census Tract 508, Williamson County, Tennessee",2995,155,5.18,2840,27.86
525,47149042000,"Census Tract 420, Rutherford County, Tennessee",2306,68,2.95,2238,30.72,"Census Tract 420, Rutherford County, Tennessee",2768,233,8.42,2535,30.27,"Census Tract 420, Rutherford County, Tennessee",2673,408,15.26,2265,28.19
526,47149041800,"Census Tract 418, Rutherford County, Tennessee",1395,10,0.72,1385,29.79,"Census Tract 418, Rutherford County, Tennessee",1463,35,2.39,1428,31.75,"Census Tract 418, Rutherford County, Tennessee",1423,62,4.36,1361,30.18
527,47149040403,"Census Tract 404.03, Rutherford County, Tennessee",3533,40,1.13,3493,31.28,"Census Tract 404.03, Rutherford County, Tennessee",3649,157,4.3,3492,38.74,"Census Tract 404.03, Rutherford County, Tennessee",3861,177,4.58,3684,42.25
528,47149042100,"Census Tract 421, Rutherford County, Tennessee",4793,82,1.71,4711,28.16,"Census Tract 421, Rutherford County, Tennessee",5306,67,1.26,5239,27.07,"Census Tract 421, Rutherford County, Tennessee",5705,35,0.61,5670,28.16
529,47149041000,"Census Tract 410, Rutherford County, Tennessee",3532,178,5.04,3354,31.9,"Census Tract 410, Rutherford County, Tennessee",3700,213,5.76,3487,33.53,"Census Tract 410, Rutherford County, Tennessee",4171,307,7.36,3864,38.53
530,47149040200,"Census Tract 402, Rutherford County, Tennessee",1661,34,2.05,1627,34.99,"Census Tract 402, Rutherford County, Tennessee",1948,8,0.41,1940,33.34,"Census Tract 402, Rutherford County, Tennessee",2140,69,3.22,2071,32.86
531,47093005905,"Census Tract 59.05, Knox County, Tennessee",1041,119,11.43,922,28.24,"Census Tract 59.05, Knox County, Tennessee",1274,149,11.7,1125,25.83,"Census Tract 59.05, Knox County, Tennessee",1437,103,7.17,1334,23.98
532,47149040302,"Census Tract 403.02, Rutherford County, Tennessee",4121,227,5.51,3894,35.2,"Census Tract 403.02, Rutherford County, Tennessee",4722,167,3.54,4555,37.47,"Census Tract 403.02, Rutherford County, Tennessee",5240,141,2.69,5099,37.42
533,47187050502,"Census Tract 505.02, Williamson County, Tennessee",1819,110,6.05,1709,40.19,"Census Tract 505.02, Williamson County, Tennessee",1767,108,6.11,1659,38.2,"Census Tract 505.02, Williamson County, Tennessee",1766,141,7.98,1625,39.04
534,47149041500,"Census Tract 415, Rutherford County, Tennessee",698,13,1.86,685,20.05,"Census Tract 415, Rutherford County, Tennessee",718,50,6.96,668,20.62,"Census Tract 415, Rutherford County, Tennessee",932,122,13.09,810,20.21
535,47149041600,"Census Tract 416, Rutherford County, Tennessee",3182,51,1.6,3131,30.74,"Census Tract 416, Rutherford County, Tennessee",3356,79,2.35,3277,32.07,"Census Tract 416, Rutherford County, Tennessee",3334,34,1.02,3300,33.54
536,47149041700,"Census Tract 417, Rutherford County, Tennessee",2373,118,4.97,2255,26.67,"Census Tract 417, Rutherford County, Tennessee",2670,90,3.37,2580,26.32,"Census Tract 417, Rutherford County, Tennessee",3607,48,1.33,3559,30.9
537,47149041900,"Census Tract 419, Rutherford County, Tennessee",1825,0,0.0,1825,29.09,"Census Tract 419, Rutherford County, Tennessee",1848,6,0.32,1842,30.12,"Census Tract 419, Rutherford County, Tennessee",1896,42,2.22,1854,27.46
538,47143975402,"Census Tract 9754.02, Rhea County, Tennessee",1338,29,2.17,1309,21.95,"Census Tract 9754.02, Rhea County, Tennessee",1492,47,3.15,1445,23.04,"Census Tract 9754.02, Rhea County, Tennessee",1488,51,3.43,1437,25.83
539,47093005707,"Census Tract 57.07, Knox County, Tennessee",1569,141,8.99,1428,26.18,"Census Tract 57.07, Knox County, Tennessee",1594,165,10.35,1429,24.77,"Census Tract 57.07, Knox County, Tennessee",1802,143,7.94,1659,24.15
540,47093005908,"Census Tract 59.08, Knox County, Tennessee",2452,158,6.44,2294,28.59,"Census Tract 59.08, Knox County, Tennessee",2549,178,6.98,2371,26.23,"Census Tract 59.08, Knox County, Tennessee",2412,157,6.51,2255,24.5
541,47093006103,"Census Tract 61.03, Knox County, Tennessee",2577,61,2.37,2516,28.9,"Census Tract 61.03, Knox County, Tennessee",2307,17,0.74,2290,31.1,"Census Tract 61.03, Knox County, Tennessee",2395,166,6.93,2229,32.28
542,47093005903,"Census Tract 59.03, Knox County, Tennessee",1970,122,6.19,1848,23.8,"Census Tract 59.03, Knox County, Tennessee",2172,87,4.01,2085,22.89,"Census Tract 59.03, Knox County, Tennessee",2167,126,5.81,2041,24.24
543,47093005907,"Census Tract 59.07, Knox County, Tennessee",1713,25,1.46,1688,26.1,"Census Tract 59.07, Knox County, Tennessee",1858,84,4.52,1774,27.74,"Census Tract 59.07, Knox County, Tennessee",2297,174,7.58,2123,26.57
544,47093006402,"Census Tract 64.02, Knox County, Tennessee",2171,84,3.87,2087,39.26,"Census Tract 64.02, Knox County, Tennessee",2417,87,3.6,2330,38.32,"Census Tract 64.02, Knox County, Tennessee",2692,97,3.6,2595,37.82
545,47093006302,"Census Tract 63.02, Knox County, Tennessee",1225,36,2.94,1189,35.12,"Census Tract 63.02, Knox County, Tennessee",1326,46,3.47,1280,37.86,"Census Tract 63.02, Knox County, Tennessee",1402,77,5.49,1325,35.02
546,47093006501,"Census Tract 65.01, Knox County, Tennessee",1251,44,3.52,1207,29.39,"Census Tract 65.01, Knox County, Tennessee",1277,55,4.31,1222,30.75,"Census Tract 65.01, Knox County, Tennessee",1305,56,4.29,1249,31.49
547,47093006301,"Census Tract 63.01, Knox County, Tennessee",1755,26,1.48,1729,32.84,"Census Tract 63.01, Knox County, Tennessee",1572,61,3.88,1511,29.6,"Census Tract 63.01, Knox County, Tennessee",1611,57,3.54,1554,31.52
548,47093005708,"Census Tract 57.08, Knox County, Tennessee",1464,88,6.01,1376,24.56,"Census Tract 57.08, Knox County, Tennessee",1468,60,4.09,1408,24.48,"Census Tract 57.08, Knox County, Tennessee",1713,82,4.79,1631,25.44
549,47093005813,"Census Tract 58.13, Knox County, Tennessee",2603,100,3.84,2503,27.16,"Census Tract 58.13, Knox County, Tennessee",2894,279,9.64,2615,27.13,"Census Tract 58.13, Knox County, Tennessee",2682,298,11.11,2384,24.93
550,47043060200,"Census Tract 602, Dickson County, Tennessee",2602,83,3.19,2519,44.58,"Census Tract 602, Dickson County, Tennessee",2435,85,3.49,2350,46.17,"Census Tract 602, Dickson County, Tennessee",2564,105,4.1,2459,45.1
551,47065002500,"Census Tract 25, Hamilton County, Tennessee",1351,24,1.78,1327,22.14,"Census Tract 25, Hamilton County, Tennessee",1434,27,1.88,1407,23.67,"Census Tract 25, Hamilton County, Tennessee",1640,45,2.74,1595,22.73
552,47065010413,"Census Tract 104.13, Hamilton County, Tennessee",1873,58,3.1,1815,31.98,"Census Tract 104.13, Hamilton County, Tennessee",1884,100,5.31,1784,30.72,"Census Tract 104.13, Hamilton County, Tennessee",1913,307,16.05,1606,30.78
553,47065011201,"Census Tract 112.01, Hamilton County, Tennessee",4911,286,5.82,4625,31.66,"Census Tract 112.01, Hamilton County, Tennessee",5216,491,9.41,4725,29.83,"Census Tract 112.01, Hamilton County, Tennessee",5386,672,12.48,4714,30.69
554,47043060700,"Census Tract 607, Dickson County, Tennessee",2096,37,1.77,2059,44.2,"Census Tract 607, Dickson County, Tennessee",1747,114,6.53,1633,47.86,"Census Tract 607, Dickson County, Tennessee",1907,81,4.25,1826,47.37
555,47043060300,"Census Tract 603, Dickson County, Tennessee",2935,72,2.45,2863,46.71,"Census Tract 603, Dickson County, Tennessee",3153,139,4.41,3014,45.25,"Census Tract 603, Dickson County, Tennessee",3058,189,6.18,2869,46.05
556,47043060100,"Census Tract 601, Dickson County, Tennessee",1445,50,3.46,1395,44.64,"Census Tract 601, Dickson County, Tennessee",1802,74,4.11,1728,45.63,"Census Tract 601, Dickson County, Tennessee",1779,67,3.77,1712,48.77
557,47037011500,"Census Tract 115, Davidson County, Tennessee",2064,113,5.47,1951,31.35,"Census Tract 115, Davidson County, Tennessee",2314,199,8.6,2115,29.78,"Census Tract 115, Davidson County, Tennessee",2082,329,15.8,1753,31.75
558,47037015300,"Census Tract 153, Davidson County, Tennessee",3145,115,3.66,3030,30.75,"Census Tract 153, Davidson County, Tennessee",3210,162,5.05,3048,31.14,"Census Tract 153, Davidson County, Tennessee",3299,241,7.31,3058,33.16
559,47037018601,"Census Tract 186.01, Davidson County, Tennessee",1016,86,8.46,930,27.43,"Census Tract 186.01, Davidson County, Tennessee",1121,152,13.56,969,27.28,"Census Tract 186.01, Davidson County, Tennessee",1085,190,17.51,895,27.11
560,47037013000,"Census Tract 130, Davidson County, Tennessee",0,0,,0,0.0,"Census Tract 130, Davidson County, Tennessee",16,0,0.0,16,19.0,"Census Tract 130, Davidson County, Tennessee",8,0,0.0,8,26.5
561,47037010903,"Census Tract 109.03, Davidson County, Tennessee",2149,0,0.0,2149,28.74,"Census Tract 109.03, Davidson County, Tennessee",2109,53,2.51,2056,27.36,"Census Tract 109.03, Davidson County, Tennessee",2580,68,2.64,2512,31.85
562,47037015401,"Census Tract 154.01, Davidson County, Tennessee",3162,77,2.44,3085,30.36,"Census Tract 154.01, Davidson County, Tennessee",2991,99,3.31,2892,31.54,"Census Tract 154.01, Davidson County, Tennessee",3042,167,5.49,2875,33.7
563,47037980200,"Census Tract 9802, Davidson County, Tennessee",0,0,,0,0.0,"Census Tract 9802, Davidson County, Tennessee",0,0,,0,0.0,"Census Tract 9802, Davidson County, Tennessee",0,0,,0,0.0
564,47037013100,"Census Tract 131, Davidson County, Tennessee",959,20,2.09,939,29.26,"Census Tract 131, Davidson County, Tennessee",1146,38,3.32,1108,31.28,"Census Tract 131, Davidson County, Tennessee",1185,49,4.14,1136,30.72
565,47037015619,"Census Tract 156.19, Davidson County, Tennessee",2635,37,1.4,2598,35.03,"Census Tract 156.19, Davidson County, Tennessee",2606,53,2.03,2553,36.34,"Census Tract 156.19, Davidson County, Tennessee",2832,109,3.85,2723,37.01
566,47037015609,"Census Tract 156.09, Davidson County, Tennessee",2651,51,1.92,2600,28.3,"Census Tract 156.09, Davidson County, Tennessee",2774,159,5.73,2615,28.43,"Census Tract 156.09, Davidson County, Tennessee",3208,208,6.48,3000,35.9
567,47037015405,"Census Tract 154.05, Davidson County, Tennessee",2548,116,4.55,2432,35.22,"Census Tract 154.05, Davidson County, Tennessee",2733,173,6.33,2560,39.46,"Census Tract 154.05, Davidson County, Tennessee",2764,149,5.39,2615,38.79
568,47037019112,"Census Tract 191.12, Davidson County, Tennessee",2217,69,3.11,2148,32.03,"Census Tract 191.12, Davidson County, Tennessee",2390,43,1.8,2347,30.91,"Census Tract 191.12, Davidson County, Tennessee",2692,99,3.68,2593,35.44
569,47037018407,"Census Tract 184.07, Davidson County, Tennessee",2239,129,5.76,2110,32.88,"Census Tract 184.07, Davidson County, Tennessee",2427,185,7.62,2242,36.39,"Census Tract 184.07, Davidson County, Tennessee",2740,258,9.42,2482,36.32
570,47037011700,"Census Tract 117, Davidson County, Tennessee",3773,304,8.06,3469,28.56,"Census Tract 117, Davidson County, Tennessee",4001,264,6.6,3737,27.34,"Census Tract 117, Davidson County, Tennessee",3983,342,8.59,3641,28.64
571,47037018404,"Census Tract 184.04, Davidson County, Tennessee",2731,282,10.33,2449,27.33,"Census Tract 184.04, Davidson County, Tennessee",2948,324,10.99,2624,28.24,"Census Tract 184.04, Davidson County, Tennessee",3170,333,10.5,2837,29.61
572,47037012801,"Census Tract 128.01, Davidson County, Tennessee",1812,0,0.0,1812,27.85,"Census Tract 128.01, Davidson County, Tennessee",2288,25,1.09,2263,30.43,"Census Tract 128.01, Davidson County, Tennessee",2415,56,2.32,2359,32.04
573,47037011600,"Census Tract 116, Davidson County, Tennessee",2852,168,5.89,2684,30.14,"Census Tract 116, Davidson County, Tennessee",2815,155,5.51,2660,28.66,"Census Tract 116, Davidson County, Tennessee",3345,233,6.97,3112,26.87
574,47037018500,"Census Tract 185, Davidson County, Tennessee",2234,103,4.61,2131,23.63,"Census Tract 185, Davidson County, Tennessee",2271,152,6.69,2119,23.09,"Census Tract 185, Davidson County, Tennessee",2478,151,6.09,2327,25.05
575,47037019111,"Census Tract 191.11, Davidson County, Tennessee",2522,55,2.18,2467,31.89,"Census Tract 191.11, Davidson County, Tennessee",2552,59,2.31,2493,33.8,"Census Tract 191.11, Davidson County, Tennessee",2652,67,2.53,2585,33.58
576,47037010901,"Census Tract 109.01, Davidson County, Tennessee",1481,121,8.17,1360,27.52,"Census Tract 109.01, Davidson County, Tennessee",1823,102,5.6,1721,29.87,"Census Tract 109.01, Davidson County, Tennessee",1744,46,2.64,1698,32.17
577,47037015617,"Census Tract 156.17, Davidson County, Tennessee",1344,46,3.42,1298,36.42,"Census Tract 156.17, Davidson County, Tennessee",1459,81,5.55,1378,38.88,"Census Tract 156.17, Davidson County, Tennessee",1297,81,6.25,1216,42.58
578,47037018000,"Census Tract 180, Davidson County, Tennessee",2709,242,8.93,2467,21.28,"Census Tract 180, Davidson County, Tennessee",3099,295,9.52,2804,21.35,"Census Tract 180, Davidson County, Tennessee",3109,321,10.32,2788,20.18
579,47037012701,"Census Tract 127.01, Davidson County, Tennessee",1985,0,0.0,1985,25.22,"Census Tract 127.01, Davidson County, Tennessee",2343,12,0.51,2331,24.0,"Census Tract 127.01, Davidson County, Tennessee",2239,16,0.71,2223,26.14
580,47037015610,"Census Tract 156.10, Davidson County, Tennessee",5075,231,4.55,4844,30.83,"Census Tract 156.10, Davidson County, Tennessee",5718,294,5.14,5424,33.95,"Census Tract 156.10, Davidson County, Tennessee",5473,256,4.68,5217,34.04
581,47037018408,"Census Tract 184.08, Davidson County, Tennessee",1875,139,7.41,1736,35.92,"Census Tract 184.08, Davidson County, Tennessee",1906,168,8.81,1738,35.59,"Census Tract 184.08, Davidson County, Tennessee",1912,192,10.04,1720,34.2
582,47037015615,"Census Tract 156.15, Davidson County, Tennessee",2391,51,2.13,2340,30.52,"Census Tract 156.15, Davidson County, Tennessee",2313,33,1.43,2280,31.36,"Census Tract 156.15, Davidson County, Tennessee",2129,46,2.16,2083,31.36
583,47037018201,"Census Tract 182.01, Davidson County, Tennessee",1421,93,6.54,1328,26.27,"Census Tract 182.01, Davidson County, Tennessee",1529,67,4.38,1462,25.87,"Census Tract 182.01, Davidson County, Tennessee",1631,124,7.6,1507,29.42
584,47037018405,"Census Tract 184.05, Davidson County, Tennessee",2369,127,5.36,2242,33.3,"Census Tract 184.05, Davidson County, Tennessee",2407,118,4.9,2289,33.22,"Census Tract 184.05, Davidson County, Tennessee",2418,99,4.09,2319,33.76
585,47093005704,"Census Tract 57.04, Knox County, Tennessee",3509,178,5.07,3331,22.4,"Census Tract 57.04, Knox County, Tennessee",3893,171,4.39,3722,20.92,"Census Tract 57.04, Knox County, Tennessee",3900,322,8.26,3578,23.51
586,47047060501,"Census Tract 605.01, Fayette County, Tennessee",1537,86,5.6,1451,37.47,"Census Tract 605.01, Fayette County, Tennessee",1477,95,6.43,1382,33.97,"Census Tract 605.01, Fayette County, Tennessee",1440,82,5.69,1358,35.59
587,47037010501,"Census Tract 105.01, Davidson County, Tennessee",2541,201,7.91,2340,41.16,"Census Tract 105.01, Davidson County, Tennessee",2908,285,9.8,2623,42.76,"Census Tract 105.01, Davidson County, Tennessee",3006,178,5.92,2828,35.71
588,47037010502,"Census Tract 105.02, Davidson County, Tennessee",2479,73,2.94,2406,32.85,"Census Tract 105.02, Davidson County, Tennessee",2394,140,5.85,2254,33.21,"Census Tract 105.02, Davidson County, Tennessee",2603,169,6.49,2434,31.86
589,47037011200,"Census Tract 112, Davidson County, Tennessee",2062,119,5.77,1943,29.79,"Census Tract 112, Davidson County, Tennessee",2335,299,12.81,2036,29.01,"Census Tract 112, Davidson County, Tennessee",2506,404,16.12,2102,29.73
590,47037011800,"Census Tract 118, Davidson County, Tennessee",1126,8,0.71,1118,25.68,"Census Tract 118, Davidson County, Tennessee",1085,94,8.66,991,23.09,"Census Tract 118, Davidson County, Tennessee",1356,150,11.06,1206,20.84
591,47037011900,"Census Tract 119, Davidson County, Tennessee",1215,48,3.95,1167,26.96,"Census Tract 119, Davidson County, Tennessee",1261,49,3.89,1212,25.81,"Census Tract 119, Davidson County, Tennessee",1565,37,2.36,1528,25.29
592,47183968600,"Census Tract 9686, Weakley County, Tennessee",1494,46,3.08,1448,32.23,"Census Tract 9686, Weakley County, Tennessee",1429,33,2.31,1396,33.31,"Census Tract 9686, Weakley County, Tennessee",1468,48,3.27,1420,35.63
593,47183968500,"Census Tract 9685, Weakley County, Tennessee",1930,14,0.73,1916,28.26,"Census Tract 9685, Weakley County, Tennessee",1761,0,0.0,1761,26.89,"Census Tract 9685, Weakley County, Tennessee",1871,15,0.8,1856,26.23
594,47183968700,"Census Tract 9687, Weakley County, Tennessee",528,17,3.22,511,32.08,"Census Tract 9687, Weakley County, Tennessee",539,25,4.64,514,30.04,"Census Tract 9687, Weakley County, Tennessee",595,11,1.85,584,34.74
595,47183968000,"Census Tract 9680, Weakley County, Tennessee",350,13,3.71,337,38.46,"Census Tract 9680, Weakley County, Tennessee",395,5,1.27,390,40.31,"Census Tract 9680, Weakley County, Tennessee",482,6,1.24,476,45.07
596,47183968400,"Census Tract 9684, Weakley County, Tennessee",2236,0,0.0,2236,21.8,"Census Tract 9684, Weakley County, Tennessee",2189,14,0.64,2175,24.86,"Census Tract 9684, Weakley County, Tennessee",2047,20,0.98,2027,25.78
597,47183968300,"Census Tract 9683, Weakley County, Tennessee",956,0,0.0,956,31.08,"Census Tract 9683, Weakley County, Tennessee",920,14,1.52,906,28.05,"Census Tract 9683, Weakley County, Tennessee",950,23,2.42,927,29.24
598,47037012100,"Census Tract 121, Davidson County, Tennessee",1535,83,5.41,1452,26.09,"Census Tract 121, Davidson County, Tennessee",1597,107,6.7,1490,27.68,"Census Tract 121, Davidson County, Tennessee",1659,257,15.49,1402,28.33
599,47037012200,"Census Tract 122, Davidson County, Tennessee",1229,135,10.98,1094,25.71,"Census Tract 122, Davidson County, Tennessee",1374,195,14.19,1179,28.78,"Census Tract 122, Davidson County, Tennessee",1263,205,16.23,1058,29.77
600,47093003000,"Census Tract 30, Knox County, Tennessee",2105,0,0.0,2105,23.16,"Census Tract 30, Knox County, Tennessee",2418,27,1.12,2391,21.49,"Census Tract 30, Knox County, Tennessee",2633,61,2.32,2572,22.65
601,47093002000,"Census Tract 20, Knox County, Tennessee",1583,30,1.9,1553,24.73,"Census Tract 20, Knox County, Tennessee",1418,29,2.05,1389,27.33,"Census Tract 20, Knox County, Tennessee",1192,0,0.0,1192,26.71
602,47093004300,"Census Tract 43, Knox County, Tennessee",1252,47,3.75,1205,25.45,"Census Tract 43, Knox County, Tennessee",1365,28,2.05,1337,29.11,"Census Tract 43, Knox County, Tennessee",1379,37,2.68,1342,28.84
603,47093001500,"Census Tract 15, Knox County, Tennessee",1670,0,0.0,1670,26.65,"Census Tract 15, Knox County, Tennessee",1771,10,0.56,1761,25.45,"Census Tract 15, Knox County, Tennessee",1882,24,1.28,1858,23.95
604,47093002900,"Census Tract 29, Knox County, Tennessee",1458,41,2.81,1417,23.08,"Census Tract 29, Knox County, Tennessee",1398,61,4.36,1337,21.49,"Census Tract 29, Knox County, Tennessee",1526,47,3.08,1479,25.11
605,47093002300,"Census Tract 23, Knox County, Tennessee",1664,121,7.27,1543,21.93,"Census Tract 23, Knox County, Tennessee",1862,130,6.98,1732,23.26,"Census Tract 23, Knox County, Tennessee",1765,42,2.38,1723,24.83
606,47093004700,"Census Tract 47, Knox County, Tennessee",2127,74,3.48,2053,24.97,"Census Tract 47, Knox County, Tennessee",2280,69,3.03,2211,27.09,"Census Tract 47, Knox County, Tennessee",2308,49,2.12,2259,31.57
607,47093004401,"Census Tract 44.01, Knox County, Tennessee",2779,60,2.16,2719,21.04,"Census Tract 44.01, Knox County, Tennessee",2811,70,2.49,2741,21.63,"Census Tract 44.01, Knox County, Tennessee",2787,135,4.84,2652,20.74
608,47093006102,"Census Tract 61.02, Knox County, Tennessee",2377,82,3.45,2295,26.68,"Census Tract 61.02, Knox County, Tennessee",2480,106,4.27,2374,29.12,"Census Tract 61.02, Knox County, Tennessee",2844,147,5.17,2697,26.41
609,47093005201,"Census Tract 52.01, Knox County, Tennessee",2408,64,2.66,2344,28.67,"Census Tract 52.01, Knox County, Tennessee",2924,105,3.59,2819,30.17,"Census Tract 52.01, Knox County, Tennessee",3071,143,4.66,2928,31.14
610,47093000800,"Census Tract 8, Knox County, Tennessee",1854,30,1.62,1824,24.66,"Census Tract 8, Knox County, Tennessee",1760,22,1.25,1738,23.75,"Census Tract 8, Knox County, Tennessee",1836,0,0.0,1836,23.56
611,47093002200,"Census Tract 22, Knox County, Tennessee",1611,72,4.47,1539,23.01,"Census Tract 22, Knox County, Tennessee",1667,73,4.38,1594,25.84,"Census Tract 22, Knox County, Tennessee",1921,46,2.39,1875,26.92
612,47093005803,"Census Tract 58.03, Knox County, Tennessee",1266,57,4.5,1209,24.36,"Census Tract 58.03, Knox County, Tennessee",1380,63,4.57,1317,24.01,"Census Tract 58.03, Knox County, Tennessee",1405,61,4.34,1344,22.95
613,47093004500,"Census Tract 45, Knox County, Tennessee",3276,129,3.94,3147,20.91,"Census Tract 45, Knox County, Tennessee",3320,219,6.6,3101,21.24,"Census Tract 45, Knox County, Tennessee",3612,262,7.25,3350,23.05
614,47093006203,"Census Tract 62.03, Knox County, Tennessee",2462,18,0.73,2444,32.21,"Census Tract 62.03, Knox County, Tennessee",2431,0,0.0,2431,29.21,"Census Tract 62.03, Knox County, Tennessee",2596,187,7.2,2409,29.06
615,47093003500,"Census Tract 35, Knox County, Tennessee",2429,126,5.19,2303,20.64,"Census Tract 35, Knox County, Tennessee",2404,173,7.2,2231,21.17,"Census Tract 35, Knox County, Tennessee",2494,193,7.74,2301,21.87
616,47093003100,"Census Tract 31, Knox County, Tennessee",1379,26,1.89,1353,22.93,"Census Tract 31, Knox County, Tennessee",1420,26,1.83,1394,24.87,"Census Tract 31, Knox County, Tennessee",1254,44,3.51,1210,28.06
617,47093005202,"Census Tract 52.02, Knox County, Tennessee",1620,0,0.0,1620,26.96,"Census Tract 52.02, Knox County, Tennessee",1683,29,1.72,1654,26.84,"Census Tract 52.02, Knox County, Tennessee",1750,30,1.71,1720,25.74
618,47093002400,"Census Tract 24, Knox County, Tennessee",1544,70,4.53,1474,26.28,"Census Tract 24, Knox County, Tennessee",1701,61,3.59,1640,30.24,"Census Tract 24, Knox County, Tennessee",1967,87,4.42,1880,29.8
619,47093002800,"Census Tract 28, Knox County, Tennessee",2088,0,0.0,2088,21.15,"Census Tract 28, Knox County, Tennessee",2040,0,0.0,2040,22.27,"Census Tract 28, Knox County, Tennessee",1819,0,0.0,1819,24.55
620,47093005000,"Census Tract 50, Knox County, Tennessee",1823,74,4.06,1749,30.92,"Census Tract 50, Knox County, Tennessee",1823,75,4.11,1748,30.08,"Census Tract 50, Knox County, Tennessee",2110,130,6.16,1980,29.78
621,47093005602,"Census Tract 56.02, Knox County, Tennessee",2072,74,3.57,1998,30.44,"Census Tract 56.02, Knox County, Tennessee",1985,122,6.15,1863,32.86,"Census Tract 56.02, Knox County, Tennessee",1809,194,10.72,1615,32.73
622,47093003400,"Census Tract 34, Knox County, Tennessee",2241,141,6.29,2100,26.9,"Census Tract 34, Knox County, Tennessee",2254,179,7.94,2075,24.8,"Census Tract 34, Knox County, Tennessee",2418,197,8.15,2221,23.69
623,47147080500,"Census Tract 805, Robertson County, Tennessee",2052,60,2.92,1992,33.53,"Census Tract 805, Robertson County, Tennessee",2002,42,2.1,1960,33.35,"Census Tract 805, Robertson County, Tennessee",2444,72,2.95,2372,37.08
624,47047060600,"Census Tract 606, Fayette County, Tennessee",1676,59,3.52,1617,41.85,"Census Tract 606, Fayette County, Tennessee",1678,26,1.55,1652,44.47,"Census Tract 606, Fayette County, Tennessee",1469,6,0.41,1463,44.41
625,47047060300,"Census Tract 603, Fayette County, Tennessee",1184,37,3.12,1147,36.98,"Census Tract 603, Fayette County, Tennessee",1231,44,3.57,1187,37.52,"Census Tract 603, Fayette County, Tennessee",992,44,4.44,948,40.68
626,47147080700,"Census Tract 807, Robertson County, Tennessee",3436,235,6.84,3201,38.33,"Census Tract 807, Robertson County, Tennessee",3368,393,11.67,2975,39.92,"Census Tract 807, Robertson County, Tennessee",3756,338,9.0,3418,40.82
627,47147080101,"Census Tract 801.01, Robertson County, Tennessee",1839,48,2.61,1791,44.39,"Census Tract 801.01, Robertson County, Tennessee",2052,81,3.95,1971,43.79,"Census Tract 801.01, Robertson County, Tennessee",2253,132,5.86,2121,47.26
628,47147080401,"Census Tract 804.01, Robertson County, Tennessee",1909,4,0.21,1905,31.71,"Census Tract 804.01, Robertson County, Tennessee",2111,0,0.0,2111,32.86,"Census Tract 804.01, Robertson County, Tennessee",2129,0,0.0,2129,28.35
629,47147080402,"Census Tract 804.02, Robertson County, Tennessee",1970,78,3.96,1892,31.1,"Census Tract 804.02, Robertson County, Tennessee",2032,83,4.08,1949,28.33,"Census Tract 804.02, Robertson County, Tennessee",1937,71,3.67,1866,29.36
630,47047060800,"Census Tract 608, Fayette County, Tennessee",1034,45,4.35,989,42.04,"Census Tract 608, Fayette County, Tennessee",990,50,5.05,940,35.94,"Census Tract 608, Fayette County, Tennessee",1104,35,3.17,1069,32.17
631,47037012600,"Census Tract 126, Davidson County, Tennessee",981,33,3.36,948,30.8,"Census Tract 126, Davidson County, Tennessee",1002,32,3.19,970,29.83,"Census Tract 126, Davidson County, Tennessee",1226,95,7.75,1131,32.79
632,47037012802,"Census Tract 128.02, Davidson County, Tennessee",1074,31,2.89,1043,28.9,"Census Tract 128.02, Davidson County, Tennessee",1430,28,1.96,1402,25.95,"Census Tract 128.02, Davidson County, Tennessee",1486,42,2.83,1444,25.0
633,47037013500,"Census Tract 135, Davidson County, Tennessee",1097,49,4.47,1048,24.55,"Census Tract 135, Davidson County, Tennessee",1301,58,4.46,1243,24.13,"Census Tract 135, Davidson County, Tennessee",1695,108,6.37,1587,22.52
634,47037015618,"Census Tract 156.18, Davidson County, Tennessee",3144,63,2.0,3081,33.7,"Census Tract 156.18, Davidson County, Tennessee",3390,87,2.57,3303,36.75,"Census Tract 156.18, Davidson County, Tennessee",3548,126,3.55,3422,38.22
635,47037015802,"Census Tract 158.02, Davidson County, Tennessee",2960,37,1.25,2923,28.81,"Census Tract 158.02, Davidson County, Tennessee",3748,166,4.43,3582,29.71,"Census Tract 158.02, Davidson County, Tennessee",3341,255,7.63,3086,29.93
636,47037017401,"Census Tract 174.01, Davidson County, Tennessee",1387,46,3.32,1341,21.58,"Census Tract 174.01, Davidson County, Tennessee",1482,52,3.51,1430,21.69,"Census Tract 174.01, Davidson County, Tennessee",1258,54,4.29,1204,22.29
637,47037017402,"Census Tract 174.02, Davidson County, Tennessee",3104,96,3.09,3008,25.2,"Census Tract 174.02, Davidson County, Tennessee",3321,92,2.77,3229,26.23,"Census Tract 174.02, Davidson County, Tennessee",3087,122,3.95,2965,25.47
638,47037018101,"Census Tract 181.01, Davidson County, Tennessee",2979,96,3.22,2883,24.57,"Census Tract 181.01, Davidson County, Tennessee",3061,74,2.42,2987,26.05,"Census Tract 181.01, Davidson County, Tennessee",2784,205,7.36,2579,29.04
639,47093001400,"Census Tract 14, Knox County, Tennessee",471,0,0.0,471,27.23,"Census Tract 14, Knox County, Tennessee",621,15,2.42,606,28.99,"Census Tract 14, Knox County, Tennessee",624,8,1.28,616,24.54
640,47093001700,"Census Tract 17, Knox County, Tennessee",1036,17,1.64,1019,26.92,"Census Tract 17, Knox County, Tennessee",934,7,0.75,927,22.56,"Census Tract 17, Knox County, Tennessee",1044,49,4.69,995,22.28
641,47047060502,"Census Tract 605.02, Fayette County, Tennessee",1653,31,1.88,1622,39.66,"Census Tract 605.02, Fayette County, Tennessee",1620,47,2.9,1573,40.22,"Census Tract 605.02, Fayette County, Tennessee",1570,52,3.31,1518,38.67
642,47047060403,"Census Tract 604.03, Fayette County, Tennessee",1689,42,2.49,1647,43.27,"Census Tract 604.03, Fayette County, Tennessee",1892,62,3.28,1830,40.83,"Census Tract 604.03, Fayette County, Tennessee",2046,79,3.86,1967,42.65
643,47047060401,"Census Tract 604.01, Fayette County, Tennessee",1311,89,6.79,1222,37.68,"Census Tract 604.01, Fayette County, Tennessee",1347,187,13.88,1160,40.44,"Census Tract 604.01, Fayette County, Tennessee",1271,187,14.71,1084,37.75
644,47047060402,"Census Tract 604.02, Fayette County, Tennessee",1718,82,4.77,1636,41.65,"Census Tract 604.02, Fayette County, Tennessee",1901,70,3.68,1831,41.94,"Census Tract 604.02, Fayette County, Tennessee",1849,99,5.35,1750,43.11
645,47047060702,"Census Tract 607.02, Fayette County, Tennessee",1395,76,5.45,1319,33.42,"Census Tract 607.02, Fayette County, Tennessee",1379,84,6.09,1295,32.03,"Census Tract 607.02, Fayette County, Tennessee",1616,125,7.74,1491,32.6
646,47089070600,"Census Tract 706, Jefferson County, Tennessee",2077,108,5.2,1969,28.2,"Census Tract 706, Jefferson County, Tennessee",2269,160,7.05,2109,25.84,"Census Tract 706, Jefferson County, Tennessee",2592,127,4.9,2465,25.98
647,47047060701,"Census Tract 607.01, Fayette County, Tennessee",1013,45,4.44,968,37.18,"Census Tract 607.01, Fayette County, Tennessee",986,56,5.68,930,41.78,"Census Tract 607.01, Fayette County, Tennessee",1044,57,5.46,987,40.16
648,47047060404,"Census Tract 604.04, Fayette County, Tennessee",2626,16,0.61,2610,43.15,"Census Tract 604.04, Fayette County, Tennessee",2786,30,1.08,2756,44.84,"Census Tract 604.04, Fayette County, Tennessee",2957,35,1.18,2922,44.62
649,47037013700,"Census Tract 137, Davidson County, Tennessee",2010,112,5.57,1898,29.35,"Census Tract 137, Davidson County, Tennessee",1932,97,5.02,1835,27.96,"Census Tract 137, Davidson County, Tennessee",2786,127,4.56,2659,28.57
650,47037013800,"Census Tract 138, Davidson County, Tennessee",720,1,0.14,719,32.14,"Census Tract 138, Davidson County, Tennessee",922,12,1.3,910,31.91,"Census Tract 138, Davidson County, Tennessee",959,17,1.77,942,30.74
651,47037013900,"Census Tract 139, Davidson County, Tennessee",676,0,0.0,676,22.81,"Census Tract 139, Davidson County, Tennessee",726,0,0.0,726,24.09,"Census Tract 139, Davidson County, Tennessee",642,0,0.0,642,27.76
652,47037016000,"Census Tract 160, Davidson County, Tennessee",411,30,7.3,381,21.87,"Census Tract 160, Davidson County, Tennessee",572,12,2.1,560,24.51,"Census Tract 160, Davidson County, Tennessee",646,27,4.18,619,27.74
653,47037016200,"Census Tract 162, Davidson County, Tennessee",1280,83,6.48,1197,20.92,"Census Tract 162, Davidson County, Tennessee",1328,33,2.48,1295,22.36,"Census Tract 162, Davidson County, Tennessee",1374,113,8.22,1261,24.46
654,47037016100,"Census Tract 161, Davidson County, Tennessee",993,46,4.63,947,23.64,"Census Tract 161, Davidson County, Tennessee",1251,69,5.52,1182,18.54,"Census Tract 161, Davidson County, Tennessee",1537,99,6.44,1438,20.06
655,47037018401,"Census Tract 184.01, Davidson County, Tennessee",3754,146,3.89,3608,26.87,"Census Tract 184.01, Davidson County, Tennessee",3585,195,5.44,3390,27.81,"Census Tract 184.01, Davidson County, Tennessee",4106,287,6.99,3819,28.73
656,47037018901,"Census Tract 189.01, Davidson County, Tennessee",1315,56,4.26,1259,30.42,"Census Tract 189.01, Davidson County, Tennessee",1615,37,2.29,1578,25.99,"Census Tract 189.01, Davidson County, Tennessee",1752,33,1.88,1719,25.23
657,47037018902,"Census Tract 189.02, Davidson County, Tennessee",1630,66,4.05,1564,25.81,"Census Tract 189.02, Davidson County, Tennessee",1493,85,5.69,1408,26.76,"Census Tract 189.02, Davidson County, Tennessee",1608,114,7.09,1494,23.46
658,47037018203,"Census Tract 182.03, Davidson County, Tennessee",767,45,5.87,722,23.09,"Census Tract 182.03, Davidson County, Tennessee",727,61,8.39,666,23.89,"Census Tract 182.03, Davidson County, Tennessee",676,47,6.95,629,23.78
659,47037018602,"Census Tract 186.02, Davidson County, Tennessee",2064,158,7.66,1906,25.78,"Census Tract 186.02, Davidson County, Tennessee",2125,193,9.08,1932,25.55,"Census Tract 186.02, Davidson County, Tennessee",2022,138,6.82,1884,24.91
660,47037018700,"Census Tract 187, Davidson County, Tennessee",1654,197,11.91,1457,22.42,"Census Tract 187, Davidson County, Tennessee",1529,228,14.91,1301,21.43,"Census Tract 187, Davidson County, Tennessee",1442,203,14.08,1239,24.74
661,47089070400,"Census Tract 704, Jefferson County, Tennessee",1644,30,1.82,1614,32.81,"Census Tract 704, Jefferson County, Tennessee",1810,64,3.54,1746,33.03,"Census Tract 704, Jefferson County, Tennessee",1746,59,3.38,1687,33.58
662,47089070700,"Census Tract 707, Jefferson County, Tennessee",2977,79,2.65,2898,38.12,"Census Tract 707, Jefferson County, Tennessee",3229,136,4.21,3093,35.48,"Census Tract 707, Jefferson County, Tennessee",3418,143,4.18,3275,37.29
663,47089070100,"Census Tract 701, Jefferson County, Tennessee",2820,140,4.96,2680,27.73,"Census Tract 701, Jefferson County, Tennessee",2763,166,6.01,2597,29.47,"Census Tract 701, Jefferson County, Tennessee",3203,165,5.15,3038,30.21
664,47089070300,"Census Tract 703, Jefferson County, Tennessee",3258,121,3.71,3137,25.49,"Census Tract 703, Jefferson County, Tennessee",2840,156,5.49,2684,25.61,"Census Tract 703, Jefferson County, Tennessee",2801,148,5.28,2653,26.53
665,47089070200,"Census Tract 702, Jefferson County, Tennessee",2311,49,2.12,2262,29.0,"Census Tract 702, Jefferson County, Tennessee",2165,40,1.85,2125,29.94,"Census Tract 702, Jefferson County, Tennessee",2027,48,2.37,1979,30.15
666,47089070900,"Census Tract 709, Jefferson County, Tennessee",1908,55,2.88,1853,35.61,"Census Tract 709, Jefferson County, Tennessee",1822,91,4.99,1731,40.75,"Census Tract 709, Jefferson County, Tennessee",1775,84,4.73,1691,42.39
667,47089070800,"Census Tract 708, Jefferson County, Tennessee",3075,65,2.11,3010,34.69,"Census Tract 708, Jefferson County, Tennessee",3443,136,3.95,3307,32.45,"Census Tract 708, Jefferson County, Tennessee",3631,163,4.49,3468,31.74
668,47089070500,"Census Tract 705, Jefferson County, Tennessee",2237,43,1.92,2194,32.54,"Census Tract 705, Jefferson County, Tennessee",2143,115,5.37,2028,29.86,"Census Tract 705, Jefferson County, Tennessee",2066,80,3.87,1986,34.17
669,47187050602,"Census Tract 506.02, Williamson County, Tennessee",4529,471,10.4,4058,33.78,"Census Tract 506.02, Williamson County, Tennessee",4644,555,11.95,4089,35.0,"Census Tract 506.02, Williamson County, Tennessee",5382,662,12.3,4720,37.6
670,47139950202,"Census Tract 9502.02, Polk County, Tennessee",2554,23,0.9,2531,36.33,"Census Tract 9502.02, Polk County, Tennessee",2587,0,0.0,2587,35.66,"Census Tract 9502.02, Polk County, Tennessee",2430,21,0.86,2409,36.21
671,47093001600,"Census Tract 16, Knox County, Tennessee",1267,28,2.21,1239,24.13,"Census Tract 16, Knox County, Tennessee",1351,39,2.89,1312,24.74,"Census Tract 16, Knox County, Tennessee",1374,54,3.93,1320,27.5
672,47037010701,"Census Tract 107.01, Davidson County, Tennessee",1759,51,2.9,1708,34.66,"Census Tract 107.01, Davidson County, Tennessee",2115,117,5.53,1998,30.36,"Census Tract 107.01, Davidson County, Tennessee",2361,97,4.11,2264,34.15
673,47029980100,"Census Tract 9801, Cocke County, Tennessee",0,0,,0,0.0,"Census Tract 9801, Cocke County, Tennessee",0,0,,0,0.0,"Census Tract 9801, Cocke County, Tennessee",0,0,,0,0.0
674,47037014200,"Census Tract 142, Davidson County, Tennessee",805,75,9.32,730,23.82,"Census Tract 142, Davidson County, Tennessee",933,41,4.39,892,22.59,"Census Tract 142, Davidson County, Tennessee",859,13,1.51,846,21.81
675,47037014300,"Census Tract 143, Davidson County, Tennessee",704,8,1.14,696,21.32,"Census Tract 143, Davidson County, Tennessee",778,29,3.73,749,24.82,"Census Tract 143, Davidson County, Tennessee",923,39,4.23,884,25.56
676,47037014800,"Census Tract 148, Davidson County, Tennessee",548,12,2.19,536,24.96,"Census Tract 148, Davidson County, Tennessee",542,13,2.4,529,23.23,"Census Tract 148, Davidson County, Tennessee",794,20,2.52,774,23.84
677,47037016300,"Census Tract 163, Davidson County, Tennessee",989,34,3.44,955,18.59,"Census Tract 163, Davidson County, Tennessee",878,52,5.92,826,20.08,"Census Tract 163, Davidson County, Tennessee",1172,80,6.83,1092,21.8
678,47093004200,"Census Tract 42, Knox County, Tennessee",1875,98,5.23,1777,26.53,"Census Tract 42, Knox County, Tennessee",1679,88,5.24,1591,26.14,"Census Tract 42, Knox County, Tennessee",1896,98,5.17,1798,25.17
679,47093000901,"Census Tract 9.01, Knox County, Tennessee",418,37,8.85,381,14.63,"Census Tract 9.01, Knox County, Tennessee",495,64,12.93,431,16.77,"Census Tract 9.01, Knox County, Tennessee",520,53,10.19,467,19.55
680,47093004608,"Census Tract 46.08, Knox County, Tennessee",1575,98,6.22,1477,23.32,"Census Tract 46.08, Knox County, Tennessee",1406,54,3.84,1352,24.47,"Census Tract 46.08, Knox County, Tennessee",1507,59,3.92,1448,24.51
681,47093005501,"Census Tract 55.01, Knox County, Tennessee",1353,45,3.33,1308,25.84,"Census Tract 55.01, Knox County, Tennessee",1272,40,3.14,1232,26.17,"Census Tract 55.01, Knox County, Tennessee",1167,32,2.74,1135,33.64
682,47093003802,"Census Tract 38.02, Knox County, Tennessee",1880,32,1.7,1848,26.53,"Census Tract 38.02, Knox County, Tennessee",1854,70,3.78,1784,25.04,"Census Tract 38.02, Knox County, Tennessee",1888,119,6.3,1769,25.92
683,47093003902,"Census Tract 39.02, Knox County, Tennessee",1413,14,0.99,1399,20.85,"Census Tract 39.02, Knox County, Tennessee",1334,26,1.95,1308,21.14,"Census Tract 39.02, Knox County, Tennessee",1488,12,0.81,1476,23.51
684,47093005402,"Census Tract 54.02, Knox County, Tennessee",1592,145,9.11,1447,33.06,"Census Tract 54.02, Knox County, Tennessee",1430,137,9.58,1293,31.93,"Census Tract 54.02, Knox County, Tennessee",1231,81,6.58,1150,30.17
685,47019071600,"Census Tract 716, Carter County, Tennessee",535,56,10.47,479,45.47,"Census Tract 716, Carter County, Tennessee",508,33,6.5,475,41.1,"Census Tract 716, Carter County, Tennessee",476,17,3.57,459,43.67
686,47019070300,"Census Tract 703, Carter County, Tennessee",1811,57,3.15,1754,25.0,"Census Tract 703, Carter County, Tennessee",1950,57,2.92,1893,27.04,"Census Tract 703, Carter County, Tennessee",1923,79,4.11,1844,23.66
687,47037015100,"Census Tract 151, Davidson County, Tennessee",2509,105,4.18,2404,25.3,"Census Tract 151, Davidson County, Tennessee",2431,136,5.59,2295,27.13,"Census Tract 151, Davidson County, Tennessee",2267,211,9.31,2056,25.98
688,47037016400,"Census Tract 164, Davidson County, Tennessee",1513,273,18.04,1240,16.57,"Census Tract 164, Davidson County, Tennessee",1514,209,13.8,1305,18.82,"Census Tract 164, Davidson County, Tennessee",1677,150,8.94,1527,18.88
689,47019071100,"Census Tract 711, Carter County, Tennessee",753,6,0.8,747,21.99,"Census Tract 711, Carter County, Tennessee",620,36,5.81,584,24.07,"Census Tract 711, Carter County, Tennessee",627,44,7.02,583,27.99
690,47019071300,"Census Tract 713, Carter County, Tennessee",3015,94,3.12,2921,33.83,"Census Tract 713, Carter County, Tennessee",3233,188,5.82,3045,34.03,"Census Tract 713, Carter County, Tennessee",3525,207,5.87,3318,34.71
691,47019070800,"Census Tract 708, Carter County, Tennessee",1290,44,3.41,1246,21.52,"Census Tract 708, Carter County, Tennessee",1360,39,2.87,1321,21.98,"Census Tract 708, Carter County, Tennessee",1360,51,3.75,1309,24.4
692,47019070500,"Census Tract 705, Carter County, Tennessee",1678,107,6.38,1571,36.02,"Census Tract 705, Carter County, Tennessee",1556,93,5.98,1463,33.77,"Census Tract 705, Carter County, Tennessee",1651,59,3.57,1592,27.5
693,47019070100,"Census Tract 701, Carter County, Tennessee",495,0,0.0,495,28.8,"Census Tract 701, Carter County, Tennessee",471,14,2.97,457,22.87,"Census Tract 701, Carter County, Tennessee",538,25,4.65,513,19.92
694,47019071000,"Census Tract 710, Carter County, Tennessee",1432,64,4.47,1368,21.87,"Census Tract 710, Carter County, Tennessee",1186,66,5.56,1120,19.5,"Census Tract 710, Carter County, Tennessee",1158,48,4.15,1110,20.55
695,47053966200,"Census Tract 9662, Gibson County, Tennessee",1430,44,3.08,1386,29.0,"Census Tract 9662, Gibson County, Tennessee",1372,27,1.97,1345,29.0,"Census Tract 9662, Gibson County, Tennessee",1590,42,2.64,1548,32.36
696,47053966400,"Census Tract 9664, Gibson County, Tennessee",2196,35,1.59,2161,25.73,"Census Tract 9664, Gibson County, Tennessee",2228,0,0.0,2228,23.42,"Census Tract 9664, Gibson County, Tennessee",2299,55,2.39,2244,26.82
697,47053967100,"Census Tract 9671, Gibson County, Tennessee",2933,156,5.32,2777,30.41,"Census Tract 9671, Gibson County, Tennessee",2995,62,2.07,2933,29.87,"Census Tract 9671, Gibson County, Tennessee",3306,199,6.02,3107,27.59
698,47053966600,"Census Tract 9666, Gibson County, Tennessee",867,15,1.73,852,29.02,"Census Tract 9666, Gibson County, Tennessee",872,8,0.92,864,27.81,"Census Tract 9666, Gibson County, Tennessee",901,10,1.11,891,33.27
699,47053967300,"Census Tract 9673, Gibson County, Tennessee",542,6,1.11,536,34.37,"Census Tract 9673, Gibson County, Tennessee",543,6,1.1,537,35.36,"Census Tract 9673, Gibson County, Tennessee",477,0,0.0,477,33.42
700,47053966100,"Census Tract 9661, Gibson County, Tennessee",976,37,3.79,939,30.23,"Census Tract 9661, Gibson County, Tennessee",1021,45,4.41,976,32.55,"Census Tract 9661, Gibson County, Tennessee",960,63,6.56,897,33.99
701,47053966700,"Census Tract 9667, Gibson County, Tennessee",2321,0,0.0,2321,23.93,"Census Tract 9667, Gibson County, Tennessee",2457,0,0.0,2457,24.66,"Census Tract 9667, Gibson County, Tennessee",1910,0,0.0,1910,28.88
702,47053966800,"Census Tract 9668, Gibson County, Tennessee",534,23,4.31,511,37.82,"Census Tract 9668, Gibson County, Tennessee",508,16,3.15,492,32.0,"Census Tract 9668, Gibson County, Tennessee",540,28,5.19,512,33.33
703,47053966900,"Census Tract 9669, Gibson County, Tennessee",973,23,2.36,950,22.95,"Census Tract 9669, Gibson County, Tennessee",897,32,3.57,865,25.17,"Census Tract 9669, Gibson County, Tennessee",914,52,5.69,862,21.12
704,47053967000,"Census Tract 9670, Gibson County, Tennessee",2582,29,1.12,2553,24.74,"Census Tract 9670, Gibson County, Tennessee",2387,35,1.47,2352,22.78,"Census Tract 9670, Gibson County, Tennessee",2412,80,3.32,2332,25.46
705,47053966500,"Census Tract 9665, Gibson County, Tennessee",1696,0,0.0,1696,31.11,"Census Tract 9665, Gibson County, Tennessee",2195,0,0.0,2195,27.6,"Census Tract 9665, Gibson County, Tennessee",2125,15,0.71,2110,27.85
706,47053966300,"Census Tract 9663, Gibson County, Tennessee",1061,46,4.34,1015,38.79,"Census Tract 9663, Gibson County, Tennessee",1138,35,3.08,1103,39.54,"Census Tract 9663, Gibson County, Tennessee",1090,24,2.2,1066,36.23
707,47037015200,"Census Tract 152, Davidson County, Tennessee",1307,26,1.99,1281,25.79,"Census Tract 152, Davidson County, Tennessee",1445,33,2.28,1412,27.25,"Census Tract 152, Davidson County, Tennessee",1410,32,2.27,1378,27.2
708,47037015402,"Census Tract 154.02, Davidson County, Tennessee",2519,80,3.18,2439,31.29,"Census Tract 154.02, Davidson County, Tennessee",2597,72,2.77,2525,33.92,"Census Tract 154.02, Davidson County, Tennessee",2716,103,3.79,2613,35.33
709,47037016500,"Census Tract 165, Davidson County, Tennessee",1703,657,38.58,1046,18.45,"Census Tract 165, Davidson County, Tennessee",1817,278,15.3,1539,17.17,"Census Tract 165, Davidson County, Tennessee",2039,161,7.9,1878,16.48
710,47093001800,"Census Tract 18, Knox County, Tennessee",1095,78,7.12,1017,20.74,"Census Tract 18, Knox County, Tennessee",1203,100,8.31,1103,22.66,"Census Tract 18, Knox County, Tennessee",1222,169,13.83,1053,24.89
711,47093001900,"Census Tract 19, Knox County, Tennessee",578,5,0.87,573,27.51,"Census Tract 19, Knox County, Tennessee",580,10,1.72,570,25.47,"Census Tract 19, Knox County, Tennessee",558,13,2.33,545,23.32
712,47093002700,"Census Tract 27, Knox County, Tennessee",1133,28,2.47,1105,24.64,"Census Tract 27, Knox County, Tennessee",936,14,1.5,922,24.73,"Census Tract 27, Knox County, Tennessee",1208,0,0.0,1208,28.27
713,47037019108,"Census Tract 191.08, Davidson County, Tennessee",1646,18,1.09,1628,28.26,"Census Tract 191.08, Davidson County, Tennessee",1718,6,0.35,1712,30.39,"Census Tract 191.08, Davidson County, Tennessee",1810,21,1.16,1789,30.61
714,47037015501,"Census Tract 155.01, Davidson County, Tennessee",1992,77,3.87,1915,26.91,"Census Tract 155.01, Davidson County, Tennessee",2092,50,2.39,2042,32.89,"Census Tract 155.01, Davidson County, Tennessee",1944,32,1.65,1912,33.16
715,47037019003,"Census Tract 190.03, Davidson County, Tennessee",2076,144,6.94,1932,29.4,"Census Tract 190.03, Davidson County, Tennessee",2286,135,5.91,2151,28.87,"Census Tract 190.03, Davidson County, Tennessee",2489,129,5.18,2360,29.76
716,47093000100,"Census Tract 1, Knox County, Tennessee",1190,32,2.69,1158,21.74,"Census Tract 1, Knox County, Tennessee",1333,75,5.63,1258,20.75,"Census Tract 1, Knox County, Tennessee",1487,100,6.72,1387,22.47
717,47093003200,"Census Tract 32, Knox County, Tennessee",1208,0,0.0,1208,23.4,"Census Tract 32, Knox County, Tennessee",1170,22,1.88,1148,23.4,"Census Tract 32, Knox County, Tennessee",1226,28,2.28,1198,26.13
718,47093003700,"Census Tract 37, Knox County, Tennessee",1278,73,5.71,1205,21.18,"Census Tract 37, Knox County, Tennessee",1378,60,4.35,1318,20.59,"Census Tract 37, Knox County, Tennessee",1261,55,4.36,1206,21.05
719,47093004000,"Census Tract 40, Knox County, Tennessee",2405,13,0.54,2392,28.67,"Census Tract 40, Knox County, Tennessee",2568,24,0.93,2544,29.32,"Census Tract 40, Knox County, Tennessee",2476,20,0.81,2456,25.93
720,47093004606,"Census Tract 46.06, Knox County, Tennessee",3663,186,5.08,3477,24.43,"Census Tract 46.06, Knox County, Tennessee",3796,188,4.95,3608,25.49,"Census Tract 46.06, Knox County, Tennessee",3700,277,7.49,3423,26.49
721,47093004900,"Census Tract 49, Knox County, Tennessee",2692,92,3.42,2600,21.95,"Census Tract 49, Knox County, Tennessee",2706,111,4.1,2595,21.79,"Census Tract 49, Knox County, Tennessee",2694,34,1.26,2660,24.79
722,47093005100,"Census Tract 51, Knox County, Tennessee",2547,239,9.38,2308,32.4,"Census Tract 51, Knox County, Tennessee",3269,284,8.69,2985,32.72,"Census Tract 51, Knox County, Tennessee",3615,312,8.63,3303,32.07
723,47093005701,"Census Tract 57.01, Knox County, Tennessee",2226,91,4.09,2135,25.88,"Census Tract 57.01, Knox County, Tennessee",2200,210,9.55,1990,26.26,"Census Tract 57.01, Knox County, Tennessee",2422,267,11.02,2155,23.73
724,47187050907,"Census Tract 509.07, Williamson County, Tennessee",2938,267,9.09,2671,27.17,"Census Tract 509.07, Williamson County, Tennessee",3139,263,8.38,2876,30.02,"Census Tract 509.07, Williamson County, Tennessee",3082,259,8.4,2823,30.74
725,47187050103,"Census Tract 501.03, Williamson County, Tennessee",2116,295,13.94,1821,37.56,"Census Tract 501.03, Williamson County, Tennessee",2385,207,8.68,2178,34.94,"Census Tract 501.03, Williamson County, Tennessee",2721,274,10.07,2447,37.91
726,47037016600,"Census Tract 166, Davidson County, Tennessee",1761,91,5.17,1670,18.53,"Census Tract 166, Davidson County, Tennessee",2128,178,8.36,1950,22.47,"Census Tract 166, Davidson County, Tennessee",2235,157,7.02,2078,22.32
727,47037016800,"Census Tract 168, Davidson County, Tennessee",2855,72,2.52,2783,20.26,"Census Tract 168, Davidson County, Tennessee",2852,124,4.35,2728,19.93,"Census Tract 168, Davidson County, Tennessee",3220,168,5.22,3052,20.28
728,47037019110,"Census Tract 191.10, Davidson County, Tennessee",2064,33,1.6,2031,26.95,"Census Tract 191.10, Davidson County, Tennessee",2035,10,0.49,2025,29.12,"Census Tract 191.10, Davidson County, Tennessee",1909,25,1.31,1884,37.35
729,47187050101,"Census Tract 501.01, Williamson County, Tennessee",3848,317,8.24,3531,32.55,"Census Tract 501.01, Williamson County, Tennessee",4655,482,10.35,4173,34.75,"Census Tract 501.01, Williamson County, Tennessee",5205,604,11.6,4601,35.43
730,47187050307,"Census Tract 503.07, Williamson County, Tennessee",1940,206,10.62,1734,22.2,"Census Tract 503.07, Williamson County, Tennessee",2173,208,9.57,1965,23.83,"Census Tract 503.07, Williamson County, Tennessee",2287,196,8.57,2091,24.53
731,47187050208,"Census Tract 502.08, Williamson County, Tennessee",3780,246,6.51,3534,26.39,"Census Tract 502.08, Williamson County, Tennessee",4452,290,6.51,4162,25.88,"Census Tract 502.08, Williamson County, Tennessee",4527,522,11.53,4005,26.91
732,47187050306,"Census Tract 503.06, Williamson County, Tennessee",985,65,6.6,920,26.7,"Census Tract 503.06, Williamson County, Tennessee",1112,83,7.46,1029,24.95,"Census Tract 503.06, Williamson County, Tennessee",1118,111,9.93,1007,25.23
733,47187051201,"Census Tract 512.01, Williamson County, Tennessee",3252,478,14.7,2774,44.0,"Census Tract 512.01, Williamson County, Tennessee",3496,356,10.18,3140,40.9,"Census Tract 512.01, Williamson County, Tennessee",4049,481,11.88,3568,38.74
734,47187050702,"Census Tract 507.02, Williamson County, Tennessee",2011,296,14.72,1715,28.16,"Census Tract 507.02, Williamson County, Tennessee",2154,255,11.84,1899,30.17,"Census Tract 507.02, Williamson County, Tennessee",2213,400,18.08,1813,30.84
735,47187050406,"Census Tract 504.06, Williamson County, Tennessee",2806,470,16.75,2336,28.88,"Census Tract 504.06, Williamson County, Tennessee",2983,491,16.46,2492,29.76,"Census Tract 504.06, Williamson County, Tennessee",2977,415,13.94,2562,29.47
736,47187050904,"Census Tract 509.04, Williamson County, Tennessee",2983,167,5.6,2816,25.06,"Census Tract 509.04, Williamson County, Tennessee",3608,137,3.8,3471,23.83,"Census Tract 509.04, Williamson County, Tennessee",3341,171,5.12,3170,24.44
737,47187050303,"Census Tract 503.03, Williamson County, Tennessee",1256,90,7.17,1166,29.29,"Census Tract 503.03, Williamson County, Tennessee",1234,88,7.13,1146,29.75,"Census Tract 503.03, Williamson County, Tennessee",1431,116,8.11,1315,27.35
738,47187050305,"Census Tract 503.05, Williamson County, Tennessee",1346,126,9.36,1220,22.35,"Census Tract 503.05, Williamson County, Tennessee",1269,75,5.91,1194,23.53,"Census Tract 503.05, Williamson County, Tennessee",1312,100,7.62,1212,24.52
739,47187050405,"Census Tract 504.05, Williamson County, Tennessee",1209,138,11.41,1071,29.91,"Census Tract 504.05, Williamson County, Tennessee",1223,146,11.94,1077,33.03,"Census Tract 504.05, Williamson County, Tennessee",1243,134,10.78,1109,36.53
740,47187050403,"Census Tract 504.03, Williamson County, Tennessee",902,88,9.76,814,30.46,"Census Tract 504.03, Williamson County, Tennessee",943,124,13.15,819,34.87,"Census Tract 504.03, Williamson County, Tennessee",969,160,16.51,809,36.42
741,47187050404,"Census Tract 504.04, Williamson County, Tennessee",3075,260,8.46,2815,29.18,"Census Tract 504.04, Williamson County, Tennessee",3090,253,8.19,2837,31.14,"Census Tract 504.04, Williamson County, Tennessee",3044,440,14.45,2604,36.32
742,47187050601,"Census Tract 506.01, Williamson County, Tennessee",2884,236,8.18,2648,28.34,"Census Tract 506.01, Williamson County, Tennessee",3091,210,6.79,2881,28.46,"Census Tract 506.01, Williamson County, Tennessee",3551,329,9.26,3222,29.54
743,47043060402,"Census Tract 604.02, Dickson County, Tennessee",2706,118,4.36,2588,38.42,"Census Tract 604.02, Dickson County, Tennessee",2773,141,5.08,2632,35.5,"Census Tract 604.02, Dickson County, Tennessee",3146,118,3.75,3028,38.48
744,47187051202,"Census Tract 512.02, Williamson County, Tennessee",11036,1012,9.17,10024,39.39,"Census Tract 512.02, Williamson County, Tennessee",12717,1033,8.12,11684,39.9,"Census Tract 512.02, Williamson County, Tennessee",14239,1396,9.8,12843,38.11
745,47187050503,"Census Tract 505.03, Williamson County, Tennessee",2375,192,8.08,2183,42.58,"Census Tract 505.03, Williamson County, Tennessee",2401,190,7.91,2211,44.27,"Census Tract 505.03, Williamson County, Tennessee",2784,201,7.22,2583,46.58
746,47043060602,"Census Tract 606.02, Dickson County, Tennessee",2419,24,0.99,2395,30.76,"Census Tract 606.02, Dickson County, Tennessee",2818,31,1.1,2787,34.09,"Census Tract 606.02, Dickson County, Tennessee",3233,35,1.08,3198,35.15
747,47043060401,"Census Tract 604.01, Dickson County, Tennessee",1639,16,0.98,1623,42.55,"Census Tract 604.01, Dickson County, Tennessee",1763,57,3.23,1706,41.23,"Census Tract 604.01, Dickson County, Tennessee",1846,58,3.14,1788,41.29
748,47043060501,"Census Tract 605.01, Dickson County, Tennessee",2925,22,0.75,2903,30.27,"Census Tract 605.01, Dickson County, Tennessee",2862,34,1.19,2828,29.68,"Census Tract 605.01, Dickson County, Tennessee",2785,63,2.26,2722,32.2
749,47149041302,"Census Tract 413.02, Rutherford County, Tennessee",2919,132,4.52,2787,31.64,"Census Tract 413.02, Rutherford County, Tennessee",3182,96,3.02,3086,33.05,"Census Tract 413.02, Rutherford County, Tennessee",3146,75,2.38,3071,32.97
750,47149040805,"Census Tract 408.05, Rutherford County, Tennessee",4468,251,5.62,4217,34.8,"Census Tract 408.05, Rutherford County, Tennessee",4672,214,4.58,4458,34.43,"Census Tract 408.05, Rutherford County, Tennessee",5208,342,6.57,4866,34.99
751,47149040903,"Census Tract 409.03, Rutherford County, Tennessee",6722,168,2.5,6554,35.42,"Census Tract 409.03, Rutherford County, Tennessee",7005,278,3.97,6727,32.58,"Census Tract 409.03, Rutherford County, Tennessee",7686,380,4.94,7306,36.32
752,47189030600,"Census Tract 306, Wilson County, Tennessee",1655,39,2.36,1616,22.72,"Census Tract 306, Wilson County, Tennessee",1708,51,2.99,1657,23.89,"Census Tract 306, Wilson County, Tennessee",1790,88,4.92,1702,26.72
753,47149042200,"Census Tract 422, Rutherford County, Tennessee",2510,26,1.04,2484,28.61,"Census Tract 422, Rutherford County, Tennessee",2667,42,1.57,2625,31.61,"Census Tract 422, Rutherford County, Tennessee",2618,53,2.02,2565,35.03
754,47149040902,"Census Tract 409.02, Rutherford County, Tennessee",5609,181,3.23,5428,35.16,"Census Tract 409.02, Rutherford County, Tennessee",6799,354,5.21,6445,36.85,"Census Tract 409.02, Rutherford County, Tennessee",8788,783,8.91,8005,34.84
755,47037019105,"Census Tract 191.05, Davidson County, Tennessee",2916,50,1.71,2866,35.57,"Census Tract 191.05, Davidson County, Tennessee",3049,103,3.38,2946,32.61,"Census Tract 191.05, Davidson County, Tennessee",3235,123,3.8,3112,28.95
756,47037019106,"Census Tract 191.06, Davidson County, Tennessee",2569,26,1.01,2543,28.92,"Census Tract 191.06, Davidson County, Tennessee",2684,167,6.22,2517,30.2,"Census Tract 191.06, Davidson County, Tennessee",2587,154,5.95,2433,29.41
757,47037015502,"Census Tract 155.02, Davidson County, Tennessee",1970,204,10.36,1766,27.02,"Census Tract 155.02, Davidson County, Tennessee",2162,191,8.83,1971,27.19,"Census Tract 155.02, Davidson County, Tennessee",2102,213,10.13,1889,27.22
758,47037017100,"Census Tract 171, Davidson County, Tennessee",1473,111,7.54,1362,20.78,"Census Tract 171, Davidson County, Tennessee",1669,149,8.93,1520,18.67,"Census Tract 171, Davidson County, Tennessee",2164,162,7.49,2002,20.68
759,47037016900,"Census Tract 169, Davidson County, Tennessee",3052,246,8.06,2806,19.77,"Census Tract 169, Davidson County, Tennessee",3302,304,9.21,2998,19.33,"Census Tract 169, Davidson County, Tennessee",3299,340,10.31,2959,22.44
760,47189030901,"Census Tract 309.01, Wilson County, Tennessee",5568,411,7.38,5157,36.34,"Census Tract 309.01, Wilson County, Tennessee",6016,445,7.4,5571,39.33,"Census Tract 309.01, Wilson County, Tennessee",6332,381,6.02,5951,40.27
761,47189030304,"Census Tract 303.04, Wilson County, Tennessee",3269,214,6.55,3055,39.29,"Census Tract 303.04, Wilson County, Tennessee",3376,275,8.15,3101,39.22,"Census Tract 303.04, Wilson County, Tennessee",3455,264,7.64,3191,38.64
762,47189030500,"Census Tract 305, Wilson County, Tennessee",2489,24,0.96,2465,27.3,"Census Tract 305, Wilson County, Tennessee",2745,30,1.09,2715,29.29,"Census Tract 305, Wilson County, Tennessee",3264,103,3.16,3161,31.4
763,47189030700,"Census Tract 307, Wilson County, Tennessee",1027,34,3.31,993,25.64,"Census Tract 307, Wilson County, Tennessee",973,23,2.36,950,25.03,"Census Tract 307, Wilson County, Tennessee",1369,86,6.28,1283,24.02
764,47189031000,"Census Tract 310, Wilson County, Tennessee",2746,123,4.48,2623,41.93,"Census Tract 310, Wilson County, Tennessee",2624,96,3.66,2528,44.34,"Census Tract 310, Wilson County, Tennessee",2556,149,5.83,2407,42.87
765,47189030202,"Census Tract 302.02, Wilson County, Tennessee",3336,139,4.17,3197,32.62,"Census Tract 302.02, Wilson County, Tennessee",3661,222,6.06,3439,31.15,"Census Tract 302.02, Wilson County, Tennessee",3820,249,6.52,3571,33.9
766,47187050908,"Census Tract 509.08, Williamson County, Tennessee",1610,180,11.18,1430,36.6,"Census Tract 509.08, Williamson County, Tennessee",1782,275,15.43,1507,39.48,"Census Tract 509.08, Williamson County, Tennessee",2027,289,14.26,1738,36.29
767,47139950400,"Census Tract 9504, Polk County, Tennessee",1110,7,0.63,1103,34.44,"Census Tract 9504, Polk County, Tennessee",1226,12,0.98,1214,29.72,"Census Tract 9504, Polk County, Tennessee",1439,64,4.45,1375,28.72
768,47139950100,"Census Tract 9501, Polk County, Tennessee",550,36,6.55,514,39.86,"Census Tract 9501, Polk County, Tennessee",470,14,2.98,456,35.03,"Census Tract 9501, Polk County, Tennessee",462,21,4.55,441,35.24
769,47139950300,"Census Tract 9503, Polk County, Tennessee",1170,25,2.14,1145,32.97,"Census Tract 9503, Polk County, Tennessee",1434,59,4.11,1375,35.65,"Census Tract 9503, Polk County, Tennessee",1716,64,3.73,1652,36.32
770,47041920102,"Census Tract 9201.02, DeKalb County, Tennessee",1830,11,0.6,1819,38.23,"Census Tract 9201.02, DeKalb County, Tennessee",2142,1,0.05,2141,33.66,"Census Tract 9201.02, DeKalb County, Tennessee",2290,35,1.53,2255,31.23
771,47041920101,"Census Tract 9201.01, DeKalb County, Tennessee",804,30,3.73,774,30.47,"Census Tract 9201.01, DeKalb County, Tennessee",896,39,4.35,857,34.21,"Census Tract 9201.01, DeKalb County, Tennessee",1097,78,7.11,1019,33.25
772,47187051002,"Census Tract 510.02, Williamson County, Tennessee",3262,461,14.13,2801,26.63,"Census Tract 510.02, Williamson County, Tennessee",3481,687,19.74,2794,27.92,"Census Tract 510.02, Williamson County, Tennessee",4684,833,17.78,3851,31.39
773,47187050909,"Census Tract 509.09, Williamson County, Tennessee",1796,146,8.13,1650,40.35,"Census Tract 509.09, Williamson County, Tennessee",2057,182,8.85,1875,37.08,"Census Tract 509.09, Williamson County, Tennessee",2260,220,9.73,2040,30.64
774,47109930100,"Census Tract 9301, McNairy County, Tennessee",1290,53,4.11,1237,31.59,"Census Tract 9301, McNairy County, Tennessee",1371,95,6.93,1276,34.84,"Census Tract 9301, McNairy County, Tennessee",1458,48,3.29,1410,33.83
775,47109930500,"Census Tract 9305, McNairy County, Tennessee",2472,177,7.16,2295,25.42,"Census Tract 9305, McNairy County, Tennessee",2756,175,6.35,2581,27.37,"Census Tract 9305, McNairy County, Tennessee",2529,68,2.69,2461,27.63
776,47109930200,"Census Tract 9302, McNairy County, Tennessee",766,51,6.66,715,38.86,"Census Tract 9302, McNairy County, Tennessee",739,77,10.42,662,41.93,"Census Tract 9302, McNairy County, Tennessee",930,132,14.19,798,38.47
777,47109930700,"Census Tract 9307, McNairy County, Tennessee",846,26,3.07,820,32.36,"Census Tract 9307, McNairy County, Tennessee",1134,89,7.85,1045,30.18,"Census Tract 9307, McNairy County, Tennessee",1267,106,8.37,1161,28.52
778,47109930300,"Census Tract 9303, McNairy County, Tennessee",1197,5,0.42,1192,35.11,"Census Tract 9303, McNairy County, Tennessee",839,15,1.79,824,33.57,"Census Tract 9303, McNairy County, Tennessee",863,19,2.2,844,31.62
779,47109930400,"Census Tract 9304, McNairy County, Tennessee",742,9,1.21,733,31.83,"Census Tract 9304, McNairy County, Tennessee",809,33,4.08,776,33.82,"Census Tract 9304, McNairy County, Tennessee",713,95,13.32,618,37.64
780,47109930600,"Census Tract 9306, McNairy County, Tennessee",1519,33,2.17,1486,31.59,"Census Tract 9306, McNairy County, Tennessee",1572,10,0.64,1562,33.57,"Census Tract 9306, McNairy County, Tennessee",1555,22,1.41,1533,34.72
781,47009011602,"Census Tract 116.02, Blount County, Tennessee",4279,126,2.94,4153,30.91,"Census Tract 116.02, Blount County, Tennessee",3977,265,6.66,3712,34.29,"Census Tract 116.02, Blount County, Tennessee",4526,429,9.48,4097,34.12
782,47031970802,"Census Tract 9708.02, Coffee County, Tennessee",2685,91,3.39,2594,27.11,"Census Tract 9708.02, Coffee County, Tennessee",2478,107,4.32,2371,24.91,"Census Tract 9708.02, Coffee County, Tennessee",2927,76,2.6,2851,23.75
783,47075930301,"Census Tract 9303.01, Haywood County, Tennessee",1617,25,1.55,1592,27.07,"Census Tract 9303.01, Haywood County, Tennessee",1725,46,2.67,1679,27.25,"Census Tract 9303.01, Haywood County, Tennessee",1518,48,3.16,1470,26.76
784,47075930302,"Census Tract 9303.02, Haywood County, Tennessee",1257,0,0.0,1257,29.99,"Census Tract 9303.02, Haywood County, Tennessee",1336,0,0.0,1336,26.38,"Census Tract 9303.02, Haywood County, Tennessee",1422,23,1.62,1399,24.4
785,47039955001,"Census Tract 9550.01, Decatur County, Tennessee",688,8,1.16,680,39.9,"Census Tract 9550.01, Decatur County, Tennessee",723,19,2.63,704,36.75,"Census Tract 9550.01, Decatur County, Tennessee",669,29,4.33,640,31.66
786,47039955101,"Census Tract 9551.01, Decatur County, Tennessee",714,20,2.8,694,32.2,"Census Tract 9551.01, Decatur County, Tennessee",747,49,6.56,698,36.43,"Census Tract 9551.01, Decatur County, Tennessee",723,76,10.51,647,36.02
787,47001980100,"Census Tract 9801, Anderson County, Tennessee",0,0,,0,0.0,"Census Tract 9801, Anderson County, Tennessee",0,0,,0,0.0,"Census Tract 9801, Anderson County, Tennessee",0,0,,0,0.0
788,47117955400,"Census Tract 9554, Marshall County, Tennessee",1731,20,1.16,1711,30.41,"Census Tract 9554, Marshall County, Tennessee",1644,31,1.89,1613,29.92,"Census Tract 9554, Marshall County, Tennessee",1684,26,1.54,1658,31.88
789,47001020202,"Census Tract 202.02, Anderson County, Tennessee",1805,60,3.32,1745,26.34,"Census Tract 202.02, Anderson County, Tennessee",1814,76,4.19,1738,27.65,"Census Tract 202.02, Anderson County, Tennessee",1639,43,2.62,1596,25.14
790,47001020201,"Census Tract 202.01, Anderson County, Tennessee",2104,99,4.71,2005,21.43,"Census Tract 202.01, Anderson County, Tennessee",1951,95,4.87,1856,23.72,"Census Tract 202.01, Anderson County, Tennessee",2013,129,6.41,1884,26.76
791,47065011100,"Census Tract 111, Hamilton County, Tennessee",2980,437,14.66,2543,28.24,"Census Tract 111, Hamilton County, Tennessee",2429,252,10.37,2177,27.02,"Census Tract 111, Hamilton County, Tennessee",2481,210,8.46,2271,28.09
792,47007953100,"Census Tract 9531, Bledsoe County, Tennessee",2278,118,5.18,2160,33.33,"Census Tract 9531, Bledsoe County, Tennessee",2360,99,4.19,2261,33.99,"Census Tract 9531, Bledsoe County, Tennessee",2382,186,7.81,2196,31.44
793,47007953000,"Census Tract 9530, Bledsoe County, Tennessee",1386,71,5.12,1315,52.17,"Census Tract 9530, Bledsoe County, Tennessee",1378,32,2.32,1346,42.7,"Census Tract 9530, Bledsoe County, Tennessee",1378,59,4.28,1319,44.91
794,47007953200,"Census Tract 9532, Bledsoe County, Tennessee",1014,38,3.75,976,37.99,"Census Tract 9532, Bledsoe County, Tennessee",1406,79,5.62,1327,44.6,"Census Tract 9532, Bledsoe County, Tennessee",1531,68,4.44,1463,49.38
795,47009010600,"Census Tract 106, Blount County, Tennessee",1655,49,2.96,1606,21.51,"Census Tract 106, Blount County, Tennessee",1697,60,3.54,1637,22.07,"Census Tract 106, Blount County, Tennessee",1624,63,3.88,1561,22.27
796,47009010700,"Census Tract 107, Blount County, Tennessee",2015,74,3.67,1941,25.74,"Census Tract 107, Blount County, Tennessee",2172,125,5.76,2047,25.81,"Census Tract 107, Blount County, Tennessee",2476,103,4.16,2373,25.55
797,47009010200,"Census Tract 102, Blount County, Tennessee",2629,68,2.59,2561,24.02,"Census Tract 102, Blount County, Tennessee",2835,95,3.35,2740,27.22,"Census Tract 102, Blount County, Tennessee",2889,60,2.08,2829,25.82
798,47009010100,"Census Tract 101, Blount County, Tennessee",1072,0,0.0,1072,28.0,"Census Tract 101, Blount County, Tennessee",1151,0,0.0,1151,32.76,"Census Tract 101, Blount County, Tennessee",1136,75,6.6,1061,27.16
799,47009011102,"Census Tract 111.02, Blount County, Tennessee",4122,121,2.94,4001,26.05,"Census Tract 111.02, Blount County, Tennessee",4013,80,1.99,3933,25.93,"Census Tract 111.02, Blount County, Tennessee",3673,117,3.19,3556,27.53
800,47009010500,"Census Tract 105, Blount County, Tennessee",982,5,0.51,977,23.34,"Census Tract 105, Blount County, Tennessee",1092,19,1.74,1073,22.52,"Census Tract 105, Blount County, Tennessee",1101,18,1.63,1083,24.99
801,47009011200,"Census Tract 112, Blount County, Tennessee",3478,71,2.04,3407,24.08,"Census Tract 112, Blount County, Tennessee",3911,67,1.71,3844,24.09,"Census Tract 112, Blount County, Tennessee",4119,75,1.82,4044,26.91
802,47009010400,"Census Tract 104, Blount County, Tennessee",1263,60,4.75,1203,24.03,"Census Tract 104, Blount County, Tennessee",1456,73,5.01,1383,24.56,"Census Tract 104, Blount County, Tennessee",1592,75,4.71,1517,26.35
803,47009011101,"Census Tract 111.01, Blount County, Tennessee",1955,88,4.5,1867,26.99,"Census Tract 111.01, Blount County, Tennessee",2131,82,3.85,2049,30.89,"Census Tract 111.01, Blount County, Tennessee",2619,22,0.84,2597,29.7
804,47009010900,"Census Tract 109, Blount County, Tennessee",3112,331,10.64,2781,28.37,"Census Tract 109, Blount County, Tennessee",3023,66,2.18,2957,28.41,"Census Tract 109, Blount County, Tennessee",3187,91,2.86,3096,28.41
805,47009010800,"Census Tract 108, Blount County, Tennessee",904,0,0.0,904,25.32,"Census Tract 108, Blount County, Tennessee",1192,8,0.67,1184,24.68,"Census Tract 108, Blount County, Tennessee",1369,24,1.75,1345,22.7
806,47065011600,"Census Tract 116, Hamilton County, Tennessee",2338,31,1.33,2307,21.5,"Census Tract 116, Hamilton County, Tennessee",2458,20,0.81,2438,21.37,"Census Tract 116, Hamilton County, Tennessee",2561,56,2.19,2505,21.89
807,47065011402,"Census Tract 114.02, Hamilton County, Tennessee",2796,138,4.94,2658,23.94,"Census Tract 114.02, Hamilton County, Tennessee",3319,147,4.43,3172,20.46,"Census Tract 114.02, Hamilton County, Tennessee",3069,46,1.5,3023,20.93
808,47065011413,"Census Tract 114.13, Hamilton County, Tennessee",4245,79,1.86,4166,30.71,"Census Tract 114.13, Hamilton County, Tennessee",3838,125,3.26,3713,30.23,"Census Tract 114.13, Hamilton County, Tennessee",4425,376,8.5,4049,29.48
809,47065011314,"Census Tract 113.14, Hamilton County, Tennessee",2711,103,3.8,2608,23.97,"Census Tract 113.14, Hamilton County, Tennessee",2650,156,5.89,2494,24.1,"Census Tract 113.14, Hamilton County, Tennessee",2625,127,4.84,2498,29.22
810,47093006403,"Census Tract 64.03, Knox County, Tennessee",1419,43,3.03,1376,38.12,"Census Tract 64.03, Knox County, Tennessee",1511,109,7.21,1402,38.71,"Census Tract 64.03, Knox County, Tennessee",1561,166,10.63,1395,37.14
811,47093004609,"Census Tract 46.09, Knox County, Tennessee",2740,137,5.0,2603,25.29,"Census Tract 46.09, Knox County, Tennessee",2750,95,3.45,2655,30.67,"Census Tract 46.09, Knox County, Tennessee",2853,164,5.75,2689,28.88
812,47093005807,"Census Tract 58.07, Knox County, Tennessee",1471,121,8.23,1350,23.04,"Census Tract 58.07, Knox County, Tennessee",1291,48,3.72,1243,25.26,"Census Tract 58.07, Knox County, Tennessee",1408,97,6.89,1311,24.31
813,47093005809,"Census Tract 58.09, Knox County, Tennessee",2219,159,7.17,2060,26.59,"Census Tract 58.09, Knox County, Tennessee",2367,136,5.75,2231,25.13,"Census Tract 58.09, Knox County, Tennessee",2499,199,7.96,2300,23.72
814,47093004614,"Census Tract 46.14, Knox County, Tennessee",1766,51,2.89,1715,21.72,"Census Tract 46.14, Knox County, Tennessee",1781,101,5.67,1680,22.78,"Census Tract 46.14, Knox County, Tennessee",1730,126,7.28,1604,24.59
815,47093005709,"Census Tract 57.09, Knox County, Tennessee",963,76,7.89,887,26.55,"Census Tract 57.09, Knox County, Tennessee",1058,47,4.44,1011,26.89,"Census Tract 57.09, Knox County, Tennessee",1073,68,6.34,1005,27.43
816,47093005711,"Census Tract 57.11, Knox County, Tennessee",3035,291,9.59,2744,27.85,"Census Tract 57.11, Knox County, Tennessee",3000,196,6.53,2804,28.23,"Census Tract 57.11, Knox County, Tennessee",2998,164,5.47,2834,27.48
817,47167040602,"Census Tract 406.02, Tipton County, Tennessee",1670,92,5.51,1578,27.81,"Census Tract 406.02, Tipton County, Tennessee",1532,36,2.35,1496,28.65,"Census Tract 406.02, Tipton County, Tennessee",1346,45,3.34,1301,37.16
818,47093006700,"Census Tract 67, Knox County, Tennessee",1061,47,4.43,1014,24.78,"Census Tract 67, Knox County, Tennessee",1253,76,6.07,1177,28.1,"Census Tract 67, Knox County, Tennessee",1174,41,3.49,1133,24.33
819,47039955102,"Census Tract 9551.02, Decatur County, Tennessee",1390,15,1.08,1375,35.39,"Census Tract 9551.02, Decatur County, Tennessee",1279,66,5.16,1213,33.9,"Census Tract 9551.02, Decatur County, Tennessee",1370,76,5.55,1294,35.92
820,47039955002,"Census Tract 9550.02, Decatur County, Tennessee",1707,113,6.62,1594,26.74,"Census Tract 9550.02, Decatur County, Tennessee",1682,108,6.42,1574,26.82,"Census Tract 9550.02, Decatur County, Tennessee",1576,64,4.06,1512,24.57
821,47053967400,"Census Tract 9674, Gibson County, Tennessee",1866,72,3.86,1794,32.95,"Census Tract 9674, Gibson County, Tennessee",1734,49,2.83,1685,33.17,"Census Tract 9674, Gibson County, Tennessee",1529,36,2.35,1493,36.08
822,47053980100,"Census Tract 9801, Gibson County, Tennessee",9,0,0.0,9,20.67,"Census Tract 9801, Gibson County, Tennessee",11,0,0.0,11,20.82,"Census Tract 9801, Gibson County, Tennessee",0,0,,0,0.0
823,47167040302,"Census Tract 403.02, Tipton County, Tennessee",4726,78,1.65,4648,43.25,"Census Tract 403.02, Tipton County, Tennessee",5041,161,3.19,4880,42.44,"Census Tract 403.02, Tipton County, Tennessee",4928,135,2.74,4793,43.77
824,47167040601,"Census Tract 406.01, Tipton County, Tennessee",1946,45,2.31,1901,41.29,"Census Tract 406.01, Tipton County, Tennessee",2015,8,0.4,2007,41.33,"Census Tract 406.01, Tipton County, Tennessee",2180,56,2.57,2124,41.5
825,47167040700,"Census Tract 407, Tipton County, Tennessee",1627,14,0.86,1613,25.17,"Census Tract 407, Tipton County, Tennessee",1780,19,1.07,1761,26.03,"Census Tract 407, Tipton County, Tennessee",2098,21,1.0,2077,37.41
826,47167040800,"Census Tract 408, Tipton County, Tennessee",1969,59,3.0,1910,38.29,"Census Tract 408, Tipton County, Tennessee",2035,56,2.75,1979,39.51,"Census Tract 408, Tipton County, Tennessee",2115,71,3.36,2044,37.07
827,47179061602,"Census Tract 616.02, Washington County, Tennessee",4222,239,5.66,3983,27.99,"Census Tract 616.02, Washington County, Tennessee",3961,238,6.01,3723,27.64,"Census Tract 616.02, Washington County, Tennessee",3864,130,3.36,3734,28.41
828,47179061901,"Census Tract 619.01, Washington County, Tennessee",2656,58,2.18,2598,33.01,"Census Tract 619.01, Washington County, Tennessee",2712,56,2.06,2656,33.58,"Census Tract 619.01, Washington County, Tennessee",3106,29,0.93,3077,32.27
829,47179061402,"Census Tract 614.02, Washington County, Tennessee",3265,280,8.58,2985,25.14,"Census Tract 614.02, Washington County, Tennessee",3381,212,6.27,3169,24.43,"Census Tract 614.02, Washington County, Tennessee",3829,180,4.7,3649,23.27
830,47179060502,"Census Tract 605.02, Washington County, Tennessee",2875,38,1.32,2837,21.78,"Census Tract 605.02, Washington County, Tennessee",2777,17,0.61,2760,22.47,"Census Tract 605.02, Washington County, Tennessee",3106,73,2.35,3033,21.55
831,47179061601,"Census Tract 616.01, Washington County, Tennessee",1929,88,4.56,1841,27.64,"Census Tract 616.01, Washington County, Tennessee",1958,87,4.44,1871,29.15,"Census Tract 616.01, Washington County, Tennessee",2130,157,7.37,1973,30.22
832,47179061702,"Census Tract 617.02, Washington County, Tennessee",3101,156,5.03,2945,27.21,"Census Tract 617.02, Washington County, Tennessee",3340,194,5.81,3146,25.93,"Census Tract 617.02, Washington County, Tennessee",3340,223,6.68,3117,26.39
833,47179060501,"Census Tract 605.01, Washington County, Tennessee",1968,52,2.64,1916,26.53,"Census Tract 605.01, Washington County, Tennessee",2425,61,2.52,2364,27.0,"Census Tract 605.01, Washington County, Tennessee",2485,54,2.17,2431,23.15
834,47179061701,"Census Tract 617.01, Washington County, Tennessee",2869,83,2.89,2786,27.81,"Census Tract 617.01, Washington County, Tennessee",3003,277,9.22,2726,31.5,"Census Tract 617.01, Washington County, Tennessee",2979,457,15.34,2522,29.04
835,47179061401,"Census Tract 614.01, Washington County, Tennessee",2891,158,5.47,2733,23.8,"Census Tract 614.01, Washington County, Tennessee",2955,123,4.16,2832,22.96,"Census Tract 614.01, Washington County, Tennessee",2415,57,2.36,2358,25.68
836,47179061902,"Census Tract 619.02, Washington County, Tennessee",2130,189,8.87,1941,31.36,"Census Tract 619.02, Washington County, Tennessee",2198,153,6.96,2045,29.79,"Census Tract 619.02, Washington County, Tennessee",2503,104,4.16,2399,30.24
837,47179062000,"Census Tract 620, Washington County, Tennessee",1733,81,4.67,1652,20.07,"Census Tract 620, Washington County, Tennessee",1663,46,2.77,1617,22.6,"Census Tract 620, Washington County, Tennessee",1780,60,3.37,1720,24.82
838,47183968101,"Census Tract 9681.01, Weakley County, Tennessee",1541,50,3.24,1491,20.9,"Census Tract 9681.01, Weakley County, Tennessee",1345,13,0.97,1332,21.09,"Census Tract 9681.01, Weakley County, Tennessee",1518,22,1.45,1496,21.37
839,47157000700,"Census Tract 7, Shelby County, Tennessee",1781,14,0.79,1767,24.09,"Census Tract 7, Shelby County, Tennessee",1753,28,1.6,1725,29.09,"Census Tract 7, Shelby County, Tennessee",1528,11,0.72,1517,27.94
840,47157000800,"Census Tract 8, Shelby County, Tennessee",627,47,7.5,580,29.34,"Census Tract 8, Shelby County, Tennessee",687,40,5.82,647,27.64,"Census Tract 8, Shelby County, Tennessee",580,49,8.45,531,28.56
841,47157000900,"Census Tract 9, Shelby County, Tennessee",626,0,0.0,626,31.24,"Census Tract 9, Shelby County, Tennessee",677,0,0.0,677,34.42,"Census Tract 9, Shelby County, Tennessee",712,0,0.0,712,27.94
842,47107970102,"Census Tract 9701.02, McMinn County, Tennessee",2390,15,0.63,2375,27.36,"Census Tract 9701.02, McMinn County, Tennessee",2311,6,0.26,2305,28.6,"Census Tract 9701.02, McMinn County, Tennessee",2451,31,1.26,2420,24.84
843,47107970101,"Census Tract 9701.01, McMinn County, Tennessee",2397,71,2.96,2326,29.97,"Census Tract 9701.01, McMinn County, Tennessee",2378,84,3.53,2294,34.08,"Census Tract 9701.01, McMinn County, Tennessee",2880,101,3.51,2779,30.23
844,47107970401,"Census Tract 9704.01, McMinn County, Tennessee",1573,55,3.5,1518,22.22,"Census Tract 9704.01, McMinn County, Tennessee",1637,67,4.09,1570,21.31,"Census Tract 9704.01, McMinn County, Tennessee",1508,66,4.38,1442,21.4
845,47107970402,"Census Tract 9704.02, McMinn County, Tennessee",2499,45,1.8,2454,24.49,"Census Tract 9704.02, McMinn County, Tennessee",2309,83,3.59,2226,24.17,"Census Tract 9704.02, McMinn County, Tennessee",2403,91,3.79,2312,25.58
846,47161110700,"Census Tract 1107, Stewart County, Tennessee",1748,22,1.26,1726,43.0,"Census Tract 1107, Stewart County, Tennessee",1816,36,1.98,1780,40.34,"Census Tract 1107, Stewart County, Tennessee",1737,38,2.19,1699,40.35
847,47183968102,"Census Tract 9681.02, Weakley County, Tennessee",858,4,0.47,854,26.85,"Census Tract 9681.02, Weakley County, Tennessee",958,22,2.3,936,24.29,"Census Tract 9681.02, Weakley County, Tennessee",990,83,8.38,907,24.98
848,47183968201,"Census Tract 9682.01, Weakley County, Tennessee",2126,18,0.85,2108,19.77,"Census Tract 9682.01, Weakley County, Tennessee",2236,25,1.12,2211,20.53,"Census Tract 9682.01, Weakley County, Tennessee",2162,34,1.57,2128,20.22
849,47183968203,"Census Tract 9682.03, Weakley County, Tennessee",1407,0,0.0,1407,16.99,"Census Tract 9682.03, Weakley County, Tennessee",1463,0,0.0,1463,18.65,"Census Tract 9682.03, Weakley County, Tennessee",1444,8,0.55,1436,18.57
850,47183968202,"Census Tract 9682.02, Weakley County, Tennessee",579,36,6.22,543,24.52,"Census Tract 9682.02, Weakley County, Tennessee",610,26,4.26,584,19.41,"Census Tract 9682.02, Weakley County, Tennessee",631,17,2.69,614,16.41
851,47147080104,"Census Tract 801.04, Robertson County, Tennessee",3248,83,2.56,3165,35.36,"Census Tract 801.04, Robertson County, Tennessee",3473,105,3.02,3368,38.86,"Census Tract 801.04, Robertson County, Tennessee",3644,249,6.83,3395,39.79
852,47147080604,"Census Tract 806.04, Robertson County, Tennessee",2024,69,3.41,1955,32.33,"Census Tract 806.04, Robertson County, Tennessee",1917,109,5.69,1808,35.74,"Census Tract 806.04, Robertson County, Tennessee",1986,85,4.28,1901,39.25
853,47147080301,"Census Tract 803.01, Robertson County, Tennessee",1083,29,2.68,1054,26.74,"Census Tract 803.01, Robertson County, Tennessee",1207,8,0.66,1199,30.43,"Census Tract 803.01, Robertson County, Tennessee",1143,6,0.52,1137,32.85
854,47147080606,"Census Tract 806.06, Robertson County, Tennessee",2567,117,4.56,2450,35.96,"Census Tract 806.06, Robertson County, Tennessee",2860,128,4.48,2732,37.1,"Census Tract 806.06, Robertson County, Tennessee",2840,176,6.2,2664,38.97
855,47147080302,"Census Tract 803.02, Robertson County, Tennessee",1188,28,2.36,1160,33.56,"Census Tract 803.02, Robertson County, Tennessee",1223,31,2.53,1192,25.89,"Census Tract 803.02, Robertson County, Tennessee",1331,14,1.05,1317,27.63
856,47147080603,"Census Tract 806.03, Robertson County, Tennessee",2022,88,4.35,1934,37.61,"Census Tract 806.03, Robertson County, Tennessee",2010,53,2.64,1957,37.19,"Census Tract 806.03, Robertson County, Tennessee",2092,77,3.68,2015,36.1
857,47147080103,"Census Tract 801.03, Robertson County, Tennessee",2964,103,3.48,2861,30.61,"Census Tract 801.03, Robertson County, Tennessee",3071,117,3.81,2954,33.76,"Census Tract 801.03, Robertson County, Tennessee",3371,119,3.53,3252,39.47
858,47147080605,"Census Tract 806.05, Robertson County, Tennessee",1508,111,7.36,1397,44.3,"Census Tract 806.05, Robertson County, Tennessee",1530,65,4.25,1465,44.09,"Census Tract 806.05, Robertson County, Tennessee",1543,70,4.54,1473,43.6
859,47013951000,"Census Tract 9510, Campbell County, Tennessee",1014,17,1.68,997,35.23,"Census Tract 9510, Campbell County, Tennessee",921,26,2.82,895,36.92,"Census Tract 9510, Campbell County, Tennessee",849,132,15.55,717,39.71
860,47037017902,"Census Tract 179.02, Davidson County, Tennessee",2334,186,7.97,2148,24.25,"Census Tract 179.02, Davidson County, Tennessee",2289,172,7.51,2117,22.85,"Census Tract 179.02, Davidson County, Tennessee",2718,262,9.64,2456,23.58
861,47013950500,"Census Tract 9505, Campbell County, Tennessee",2178,21,0.96,2157,28.32,"Census Tract 9505, Campbell County, Tennessee",2254,93,4.13,2161,27.14,"Census Tract 9505, Campbell County, Tennessee",2336,101,4.32,2235,32.43
862,47013951100,"Census Tract 9511, Campbell County, Tennessee",2061,31,1.5,2030,33.03,"Census Tract 9511, Campbell County, Tennessee",2428,21,0.86,2407,34.86,"Census Tract 9511, Campbell County, Tennessee",2523,19,0.75,2504,40.33
863,47013950200,"Census Tract 9502, Campbell County, Tennessee",748,5,0.67,743,22.04,"Census Tract 9502, Campbell County, Tennessee",665,3,0.45,662,21.79,"Census Tract 9502, Campbell County, Tennessee",614,4,0.65,610,28.11
864,47013950700,"Census Tract 9507, Campbell County, Tennessee",1503,70,4.66,1433,28.1,"Census Tract 9507, Campbell County, Tennessee",1635,97,5.93,1538,33.32,"Census Tract 9507, Campbell County, Tennessee",1595,109,6.83,1486,34.59
865,47013950400,"Census Tract 9504, Campbell County, Tennessee",1840,9,0.49,1831,38.65,"Census Tract 9504, Campbell County, Tennessee",2068,27,1.31,2041,35.92,"Census Tract 9504, Campbell County, Tennessee",1955,41,2.1,1914,38.61
866,47013950600,"Census Tract 9506, Campbell County, Tennessee",1211,0,0.0,1211,28.94,"Census Tract 9506, Campbell County, Tennessee",1386,0,0.0,1386,29.61,"Census Tract 9506, Campbell County, Tennessee",1440,72,5.0,1368,33.15
867,47013950100,"Census Tract 9501, Campbell County, Tennessee",872,0,0.0,872,37.93,"Census Tract 9501, Campbell County, Tennessee",1036,10,0.97,1026,36.64,"Census Tract 9501, Campbell County, Tennessee",1132,14,1.24,1118,37.16
868,47027955000,"Census Tract 9550, Clay County, Tennessee",1657,70,4.22,1587,32.41,"Census Tract 9550, Clay County, Tennessee",1603,70,4.37,1533,31.64,"Census Tract 9550, Clay County, Tennessee",1701,47,2.76,1654,29.43
869,47013950800,"Census Tract 9508, Campbell County, Tennessee",784,0,0.0,784,37.62,"Census Tract 9508, Campbell County, Tennessee",839,9,1.07,830,37.09,"Census Tract 9508, Campbell County, Tennessee",928,89,9.59,839,41.44
870,47013950900,"Census Tract 9509, Campbell County, Tennessee",917,0,0.0,917,36.48,"Census Tract 9509, Campbell County, Tennessee",905,10,1.1,895,37.79,"Census Tract 9509, Campbell County, Tennessee",995,10,1.01,985,42.16
871,47013950300,"Census Tract 9503, Campbell County, Tennessee",496,7,1.41,489,33.18,"Census Tract 9503, Campbell County, Tennessee",546,45,8.24,501,33.68,"Census Tract 9503, Campbell County, Tennessee",731,46,6.29,685,50.96
872,47027955100,"Census Tract 9551, Clay County, Tennessee",1057,47,4.45,1010,34.97,"Census Tract 9551, Clay County, Tennessee",944,6,0.64,938,37.81,"Census Tract 9551, Clay County, Tennessee",948,0,0.0,948,44.61
873,47051960400,"Census Tract 9604, Franklin County, Tennessee",2981,49,1.64,2932,24.07,"Census Tract 9604, Franklin County, Tennessee",3422,61,1.78,3361,27.08,"Census Tract 9604, Franklin County, Tennessee",3598,54,1.5,3544,28.2
874,47051960600,"Census Tract 9606, Franklin County, Tennessee",1812,3,0.17,1809,30.25,"Census Tract 9606, Franklin County, Tennessee",1768,3,0.17,1765,28.38,"Census Tract 9606, Franklin County, Tennessee",1679,46,2.74,1633,29.86
875,47051960500,"Census Tract 9605, Franklin County, Tennessee",1221,5,0.41,1216,21.42,"Census Tract 9605, Franklin County, Tennessee",1244,14,1.13,1230,24.7,"Census Tract 9605, Franklin County, Tennessee",1436,35,2.44,1401,25.34
876,47051960100,"Census Tract 9601, Franklin County, Tennessee",1218,0,0.0,1218,25.7,"Census Tract 9601, Franklin County, Tennessee",1428,0,0.0,1428,28.66,"Census Tract 9601, Franklin County, Tennessee",1339,15,1.12,1324,29.22
877,47051960300,"Census Tract 9603, Franklin County, Tennessee",990,28,2.83,962,33.26,"Census Tract 9603, Franklin County, Tennessee",1064,22,2.07,1042,31.86,"Census Tract 9603, Franklin County, Tennessee",1311,30,2.29,1281,36.87
878,47051960700,"Census Tract 9607, Franklin County, Tennessee",1582,149,9.42,1433,23.11,"Census Tract 9607, Franklin County, Tennessee",1686,86,5.1,1600,22.82,"Census Tract 9607, Franklin County, Tennessee",1942,149,7.67,1793,24.48
879,47051960800,"Census Tract 9608, Franklin County, Tennessee",1476,72,4.88,1404,35.14,"Census Tract 9608, Franklin County, Tennessee",1637,48,2.93,1589,32.7,"Census Tract 9608, Franklin County, Tennessee",1577,21,1.33,1556,36.17
880,47059090300,"Census Tract 903, Greene County, Tennessee",2183,48,2.2,2135,24.07,"Census Tract 903, Greene County, Tennessee",2276,51,2.24,2225,24.8,"Census Tract 903, Greene County, Tennessee",2327,66,2.84,2261,23.47
881,47059090700,"Census Tract 907, Greene County, Tennessee",1289,45,3.49,1244,24.16,"Census Tract 907, Greene County, Tennessee",1131,17,1.5,1114,23.72,"Census Tract 907, Greene County, Tennessee",1127,4,0.35,1123,24.21
882,47059090500,"Census Tract 905, Greene County, Tennessee",2799,0,0.0,2799,26.22,"Census Tract 905, Greene County, Tennessee",2926,39,1.33,2887,25.39,"Census Tract 905, Greene County, Tennessee",3005,102,3.39,2903,24.62
883,47059091100,"Census Tract 911, Greene County, Tennessee",1626,48,2.95,1578,36.28,"Census Tract 911, Greene County, Tennessee",1649,20,1.21,1629,38.37,"Census Tract 911, Greene County, Tennessee",1782,50,2.81,1732,36.44
884,47059090900,"Census Tract 909, Greene County, Tennessee",2127,125,5.88,2002,29.4,"Census Tract 909, Greene County, Tennessee",2284,155,6.79,2129,30.54,"Census Tract 909, Greene County, Tennessee",2372,51,2.15,2321,27.57
885,47059091000,"Census Tract 910, Greene County, Tennessee",2753,14,0.51,2739,30.41,"Census Tract 910, Greene County, Tennessee",2973,86,2.89,2887,30.4,"Census Tract 910, Greene County, Tennessee",3113,159,5.11,2954,30.87
886,47059090400,"Census Tract 904, Greene County, Tennessee",2069,161,7.78,1908,21.17,"Census Tract 904, Greene County, Tennessee",2045,205,10.02,1840,18.57,"Census Tract 904, Greene County, Tennessee",2103,38,1.81,2065,22.93
887,47059090800,"Census Tract 908, Greene County, Tennessee",1977,0,0.0,1977,24.57,"Census Tract 908, Greene County, Tennessee",1801,0,0.0,1801,26.08,"Census Tract 908, Greene County, Tennessee",1792,22,1.23,1770,26.5
888,47059090200,"Census Tract 902, Greene County, Tennessee",1076,34,3.16,1042,21.23,"Census Tract 902, Greene County, Tennessee",927,29,3.13,898,22.58,"Census Tract 902, Greene County, Tennessee",923,9,0.98,914,21.03
889,47059091300,"Census Tract 913, Greene County, Tennessee",1768,5,0.28,1763,32.1,"Census Tract 913, Greene County, Tennessee",1686,28,1.66,1658,33.32,"Census Tract 913, Greene County, Tennessee",1709,22,1.29,1687,31.85
890,47059091200,"Census Tract 912, Greene County, Tennessee",1292,7,0.54,1285,32.78,"Census Tract 912, Greene County, Tennessee",1587,15,0.95,1572,29.66,"Census Tract 912, Greene County, Tennessee",1558,13,0.83,1545,33.07
891,47059091400,"Census Tract 914, Greene County, Tennessee",1162,36,3.1,1126,33.22,"Census Tract 914, Greene County, Tennessee",1132,58,5.12,1074,30.69,"Census Tract 914, Greene County, Tennessee",1207,86,7.13,1121,30.72
892,47059091500,"Census Tract 915, Greene County, Tennessee",1314,14,1.07,1300,32.68,"Census Tract 915, Greene County, Tennessee",1259,72,5.72,1187,35.57,"Census Tract 915, Greene County, Tennessee",1299,90,6.93,1209,38.02
893,47059090600,"Census Tract 906, Greene County, Tennessee",1655,61,3.69,1594,27.96,"Census Tract 906, Greene County, Tennessee",1476,69,4.67,1407,26.63,"Census Tract 906, Greene County, Tennessee",1619,123,7.6,1496,27.31
894,47059090100,"Census Tract 901, Greene County, Tennessee",1917,3,0.16,1914,17.98,"Census Tract 901, Greene County, Tennessee",1951,34,1.74,1917,18.46,"Census Tract 901, Greene County, Tennessee",1759,31,1.76,1728,22.15
895,47083120200,"Census Tract 1202, Houston County, Tennessee",724,7,0.97,717,32.72,"Census Tract 1202, Houston County, Tennessee",790,26,3.29,764,40.49,"Census Tract 1202, Houston County, Tennessee",836,25,2.99,811,38.58
896,47083120100,"Census Tract 1201, Houston County, Tennessee",1275,13,1.02,1262,47.16,"Census Tract 1201, Houston County, Tennessee",1352,52,3.85,1300,44.11,"Census Tract 1201, Houston County, Tennessee",1268,51,4.02,1217,41.02
897,47083120300,"Census Tract 1203, Houston County, Tennessee",894,19,2.13,875,41.68,"Census Tract 1203, Houston County, Tennessee",768,15,1.95,753,43.14,"Census Tract 1203, Houston County, Tennessee",828,13,1.57,815,46.07
898,47157020512,"Census Tract 205.12, Shelby County, Tennessee",2275,35,1.54,2240,21.84,"Census Tract 205.12, Shelby County, Tennessee",2178,72,3.31,2106,23.07,"Census Tract 205.12, Shelby County, Tennessee",2238,77,3.44,2161,23.35
899,47157021351,"Census Tract 213.51, Shelby County, Tennessee",1807,78,4.32,1729,24.98,"Census Tract 213.51, Shelby County, Tennessee",1970,85,4.31,1885,23.05,"Census Tract 213.51, Shelby County, Tennessee",2090,170,8.13,1920,27.57
900,47157020642,"Census Tract 206.42, Shelby County, Tennessee",4818,100,2.08,4718,30.03,"Census Tract 206.42, Shelby County, Tennessee",5305,132,2.49,5173,31.67,"Census Tract 206.42, Shelby County, Tennessee",5073,95,1.87,4978,33.94
901,47157021540,"Census Tract 215.40, Shelby County, Tennessee",5916,250,4.23,5666,31.85,"Census Tract 215.40, Shelby County, Tennessee",5972,214,3.58,5758,32.56,"Census Tract 215.40, Shelby County, Tennessee",6042,225,3.72,5817,31.06
902,47157005500,"Census Tract 55, Shelby County, Tennessee",550,7,1.27,543,25.2,"Census Tract 55, Shelby County, Tennessee",612,0,0.0,612,30.15,"Census Tract 55, Shelby County, Tennessee",644,0,0.0,644,37.22
903,47037010201,"Census Tract 102.01, Davidson County, Tennessee",2031,57,2.81,1974,33.34,"Census Tract 102.01, Davidson County, Tennessee",2355,110,4.67,2245,32.99,"Census Tract 102.01, Davidson County, Tennessee",2124,122,5.74,2002,33.92
904,47095960200,"Census Tract 9602, Lake County, Tennessee",823,32,3.89,791,26.27,"Census Tract 9602, Lake County, Tennessee",999,45,4.5,954,26.87,"Census Tract 9602, Lake County, Tennessee",957,54,5.64,903,22.52
905,47095960100,"Census Tract 9601, Lake County, Tennessee",969,10,1.03,959,20.4,"Census Tract 9601, Lake County, Tennessee",822,3,0.36,819,21.55,"Census Tract 9601, Lake County, Tennessee",812,0,0.0,812,23.73
906,47087960400,"Census Tract 9604, Jackson County, Tennessee",661,0,0.0,661,39.11,"Census Tract 9604, Jackson County, Tennessee",691,0,0.0,691,40.09,"Census Tract 9604, Jackson County, Tennessee",599,16,2.67,583,42.74
907,47087960200,"Census Tract 9602, Jackson County, Tennessee",882,27,3.06,855,37.97,"Census Tract 9602, Jackson County, Tennessee",965,42,4.35,923,40.7,"Census Tract 9602, Jackson County, Tennessee",932,52,5.58,880,37.1
908,47087960100,"Census Tract 9601, Jackson County, Tennessee",504,17,3.37,487,43.99,"Census Tract 9601, Jackson County, Tennessee",473,5,1.06,468,44.38,"Census Tract 9601, Jackson County, Tennessee",504,8,1.59,496,44.65
909,47087960300,"Census Tract 9603, Jackson County, Tennessee",1603,32,2.0,1571,33.59,"Census Tract 9603, Jackson County, Tennessee",1825,35,1.92,1790,35.18,"Census Tract 9603, Jackson County, Tennessee",2219,7,0.32,2212,33.67
910,47037015627,"Census Tract 156.27, Davidson County, Tennessee",1563,14,0.9,1549,29.19,"Census Tract 156.27, Davidson County, Tennessee",1429,29,2.03,1400,29.88,"Census Tract 156.27, Davidson County, Tennessee",1362,34,2.5,1328,34.05
911,47037015623,"Census Tract 156.23, Davidson County, Tennessee",2594,39,1.5,2555,31.53,"Census Tract 156.23, Davidson County, Tennessee",2609,116,4.45,2493,31.96,"Census Tract 156.23, Davidson County, Tennessee",2842,122,4.29,2720,32.7
912,47037980100,"Census Tract 9801, Davidson County, Tennessee",0,0,,0,0.0,"Census Tract 9801, Davidson County, Tennessee",0,0,,0,0.0,"Census Tract 9801, Davidson County, Tennessee",0,0,,0,0.0
913,47037019116,"Census Tract 191.16, Davidson County, Tennessee",3420,59,1.73,3361,33.07,"Census Tract 191.16, Davidson County, Tennessee",3661,175,4.78,3486,34.29,"Census Tract 191.16, Davidson County, Tennessee",3797,247,6.51,3550,33.82
914,47037019115,"Census Tract 191.15, Davidson County, Tennessee",2258,164,7.26,2094,32.84,"Census Tract 191.15, Davidson County, Tennessee",2352,241,10.25,2111,34.3,"Census Tract 191.15, Davidson County, Tennessee",2185,270,12.36,1915,35.0
915,47037019005,"Census Tract 190.05, Davidson County, Tennessee",1497,67,4.48,1430,32.26,"Census Tract 190.05, Davidson County, Tennessee",1530,54,3.53,1476,30.85,"Census Tract 190.05, Davidson County, Tennessee",1468,75,5.11,1393,29.62
916,47037019600,"Census Tract 196, Davidson County, Tennessee",2284,128,5.6,2156,26.25,"Census Tract 196, Davidson County, Tennessee",2696,148,5.49,2548,27.4,"Census Tract 196, Davidson County, Tennessee",2243,123,5.48,2120,28.9
917,47037019300,"Census Tract 193, Davidson County, Tennessee",804,32,3.98,772,40.27,"Census Tract 193, Davidson County, Tennessee",832,40,4.81,792,26.01,"Census Tract 193, Davidson County, Tennessee",868,14,1.61,854,22.67
918,47009011002,"Census Tract 110.02, Blount County, Tennessee",1840,107,5.82,1733,32.85,"Census Tract 110.02, Blount County, Tennessee",1986,94,4.73,1892,32.5,"Census Tract 110.02, Blount County, Tennessee",2135,123,5.76,2012,35.0
919,47009010301,"Census Tract 103.01, Blount County, Tennessee",3016,42,1.39,2974,25.92,"Census Tract 103.01, Blount County, Tennessee",3223,0,0.0,3223,26.77,"Census Tract 103.01, Blount County, Tennessee",3200,21,0.66,3179,27.54
920,47009010302,"Census Tract 103.02, Blount County, Tennessee",1334,36,2.7,1298,31.65,"Census Tract 103.02, Blount County, Tennessee",1642,40,2.44,1602,26.87,"Census Tract 103.02, Blount County, Tennessee",2052,47,2.29,2005,26.63
921,47009011001,"Census Tract 110.01, Blount County, Tennessee",2664,60,2.25,2604,26.94,"Census Tract 110.01, Blount County, Tennessee",2557,85,3.32,2472,26.44,"Census Tract 110.01, Blount County, Tennessee",2493,147,5.9,2346,24.49
922,47009011301,"Census Tract 113.01, Blount County, Tennessee",2704,203,7.51,2501,37.99,"Census Tract 113.01, Blount County, Tennessee",2991,153,5.12,2838,38.28,"Census Tract 113.01, Blount County, Tennessee",3080,192,6.23,2888,36.95
923,47009011302,"Census Tract 113.02, Blount County, Tennessee",2497,64,2.56,2433,35.17,"Census Tract 113.02, Blount County, Tennessee",2648,93,3.51,2555,37.11,"Census Tract 113.02, Blount County, Tennessee",3013,148,4.91,2865,35.79
924,47009011401,"Census Tract 114.01, Blount County, Tennessee",537,9,1.68,528,35.63,"Census Tract 114.01, Blount County, Tennessee",534,41,7.68,493,35.52,"Census Tract 114.01, Blount County, Tennessee",502,61,12.15,441,38.68
925,47009011604,"Census Tract 116.04, Blount County, Tennessee",1971,50,2.54,1921,25.14,"Census Tract 116.04, Blount County, Tennessee",1797,112,6.23,1685,27.66,"Census Tract 116.04, Blount County, Tennessee",1966,131,6.66,1835,26.02
926,47009011402,"Census Tract 114.02, Blount County, Tennessee",1927,118,6.12,1809,36.72,"Census Tract 114.02, Blount County, Tennessee",1945,192,9.87,1753,35.68,"Census Tract 114.02, Blount County, Tennessee",1806,184,10.19,1622,36.61
927,47009011503,"Census Tract 115.03, Blount County, Tennessee",3108,118,3.8,2990,34.85,"Census Tract 115.03, Blount County, Tennessee",3164,140,4.42,3024,31.22,"Census Tract 115.03, Blount County, Tennessee",3302,192,5.81,3110,32.63
928,47009011603,"Census Tract 116.03, Blount County, Tennessee",2279,86,3.77,2193,29.7,"Census Tract 116.03, Blount County, Tennessee",2285,142,6.21,2143,31.18,"Census Tract 116.03, Blount County, Tennessee",2246,175,7.79,2071,31.92
929,47009011605,"Census Tract 116.05, Blount County, Tennessee",1607,126,7.84,1481,31.63,"Census Tract 116.05, Blount County, Tennessee",1561,187,11.98,1374,33.92,"Census Tract 116.05, Blount County, Tennessee",1630,149,9.14,1481,34.73
930,47009980200,"Census Tract 9802, Blount County, Tennessee",9,0,0.0,9,11.78,"Census Tract 9802, Blount County, Tennessee",0,0,,0,0.0,"Census Tract 9802, Blount County, Tennessee",0,0,,0,0.0
931,47009011501,"Census Tract 115.01, Blount County, Tennessee",711,13,1.83,698,38.65,"Census Tract 115.01, Blount County, Tennessee",729,15,2.06,714,43.33,"Census Tract 115.01, Blount County, Tennessee",744,37,4.97,707,44.66
932,47031971000,"Census Tract 9710, Coffee County, Tennessee",2605,65,2.5,2540,24.5,"Census Tract 9710, Coffee County, Tennessee",2603,50,1.92,2553,27.95,"Census Tract 9710, Coffee County, Tennessee",2714,70,2.58,2644,26.12
933,47103975601,"Census Tract 9756.01, Lincoln County, Tennessee",2458,18,0.73,2440,32.34,"Census Tract 9756.01, Lincoln County, Tennessee",2540,14,0.55,2526,32.17,"Census Tract 9756.01, Lincoln County, Tennessee",3065,98,3.2,2967,30.74
934,47103975602,"Census Tract 9756.02, Lincoln County, Tennessee",1739,76,4.37,1663,40.69,"Census Tract 9756.02, Lincoln County, Tennessee",1594,49,3.07,1545,40.11,"Census Tract 9756.02, Lincoln County, Tennessee",1513,43,2.84,1470,45.28
935,47031970100,"Census Tract 9701, Coffee County, Tennessee",1557,10,0.64,1547,27.31,"Census Tract 9701, Coffee County, Tennessee",1781,83,4.66,1698,29.21,"Census Tract 9701, Coffee County, Tennessee",1730,168,9.71,1562,33.44
936,47031970600,"Census Tract 9706, Coffee County, Tennessee",1545,40,2.59,1505,26.66,"Census Tract 9706, Coffee County, Tennessee",1641,19,1.16,1622,27.77,"Census Tract 9706, Coffee County, Tennessee",1895,33,1.74,1862,30.52
937,47031970700,"Census Tract 9707, Coffee County, Tennessee",1537,43,2.8,1494,28.03,"Census Tract 9707, Coffee County, Tennessee",1929,43,2.23,1886,26.25,"Census Tract 9707, Coffee County, Tennessee",2170,54,2.49,2116,26.04
938,47031970300,"Census Tract 9703, Coffee County, Tennessee",721,21,2.91,700,40.26,"Census Tract 9703, Coffee County, Tennessee",729,22,3.02,707,41.62,"Census Tract 9703, Coffee County, Tennessee",781,60,7.68,721,35.38
939,47031970200,"Census Tract 9702, Coffee County, Tennessee",2617,88,3.36,2529,30.4,"Census Tract 9702, Coffee County, Tennessee",3108,76,2.45,3032,31.24,"Census Tract 9702, Coffee County, Tennessee",3338,54,1.62,3284,33.89
940,47031970400,"Census Tract 9704, Coffee County, Tennessee",2365,55,2.33,2310,27.05,"Census Tract 9704, Coffee County, Tennessee",2659,230,8.65,2429,31.81,"Census Tract 9704, Coffee County, Tennessee",3001,314,10.46,2687,31.58
941,47031970900,"Census Tract 9709, Coffee County, Tennessee",1341,28,2.09,1313,23.05,"Census Tract 9709, Coffee County, Tennessee",1465,47,3.21,1418,23.23,"Census Tract 9709, Coffee County, Tennessee",1693,78,4.61,1615,27.63
942,47149040807,"Census Tract 408.07, Rutherford County, Tennessee",2870,96,3.34,2774,41.3,"Census Tract 408.07, Rutherford County, Tennessee",3011,102,3.39,2909,40.62,"Census Tract 408.07, Rutherford County, Tennessee",3429,148,4.32,3281,37.23
943,47051960202,"Census Tract 9602.02, Franklin County, Tennessee",2284,68,2.98,2216,28.42,"Census Tract 9602.02, Franklin County, Tennessee",2379,99,4.16,2280,27.33,"Census Tract 9602.02, Franklin County, Tennessee",2280,97,4.25,2183,26.88
944,47051960201,"Census Tract 9602.01, Franklin County, Tennessee",3069,125,4.07,2944,30.23,"Census Tract 9602.01, Franklin County, Tennessee",2772,79,2.85,2693,26.84,"Census Tract 9602.01, Franklin County, Tennessee",2877,162,5.63,2715,27.43
945,47189030305,"Census Tract 303.05, Wilson County, Tennessee",2921,90,3.08,2831,34.52,"Census Tract 303.05, Wilson County, Tennessee",3287,61,1.86,3226,35.76,"Census Tract 303.05, Wilson County, Tennessee",3042,78,2.56,2964,36.29
946,47189030101,"Census Tract 301.01, Wilson County, Tennessee",3967,103,2.6,3864,33.25,"Census Tract 301.01, Wilson County, Tennessee",4537,135,2.98,4402,33.66,"Census Tract 301.01, Wilson County, Tennessee",4922,170,3.45,4752,37.95
947,47189030303,"Census Tract 303.03, Wilson County, Tennessee",2156,160,7.42,1996,41.42,"Census Tract 303.03, Wilson County, Tennessee",2282,161,7.06,2121,42.41,"Census Tract 303.03, Wilson County, Tennessee",2451,145,5.92,2306,42.84
948,47081950302,"Census Tract 9503.02, Hickman County, Tennessee",2022,121,5.98,1901,41.31,"Census Tract 9503.02, Hickman County, Tennessee",1971,64,3.25,1907,39.04,"Census Tract 9503.02, Hickman County, Tennessee",1823,33,1.81,1790,40.76
949,47081950301,"Census Tract 9503.01, Hickman County, Tennessee",1105,0,0.0,1105,46.39,"Census Tract 9503.01, Hickman County, Tennessee",1008,28,2.78,980,44.56,"Census Tract 9503.01, Hickman County, Tennessee",834,31,3.72,803,36.12
950,47189030102,"Census Tract 301.02, Wilson County, Tennessee",3267,36,1.1,3231,41.68,"Census Tract 301.02, Wilson County, Tennessee",3445,137,3.98,3308,40.07,"Census Tract 301.02, Wilson County, Tennessee",3629,212,5.84,3417,38.97
951,47189030307,"Census Tract 303.07, Wilson County, Tennessee",3728,319,8.56,3409,32.19,"Census Tract 303.07, Wilson County, Tennessee",4381,326,7.44,4055,35.01,"Census Tract 303.07, Wilson County, Tennessee",4910,258,5.25,4652,36.79
952,47189030800,"Census Tract 308, Wilson County, Tennessee",2432,231,9.5,2201,39.41,"Census Tract 308, Wilson County, Tennessee",2780,163,5.86,2617,37.17,"Census Tract 308, Wilson County, Tennessee",2736,220,8.04,2516,36.16
953,47149040104,"Census Tract 401.04, Rutherford County, Tennessee",2290,45,1.97,2245,41.37,"Census Tract 401.04, Rutherford County, Tennessee",2671,138,5.17,2533,40.75,"Census Tract 401.04, Rutherford County, Tennessee",3010,121,4.02,2889,40.47
954,47149040101,"Census Tract 401.01, Rutherford County, Tennessee",1555,9,0.58,1546,44.13,"Census Tract 401.01, Rutherford County, Tennessee",1611,9,0.56,1602,42.36,"Census Tract 401.01, Rutherford County, Tennessee",1748,9,0.51,1739,38.71
955,47149040103,"Census Tract 401.03, Rutherford County, Tennessee",4710,42,0.89,4668,39.41,"Census Tract 401.03, Rutherford County, Tennessee",4311,171,3.97,4140,43.73,"Census Tract 401.03, Rutherford County, Tennessee",4302,229,5.32,4073,44.08
956,47149040306,"Census Tract 403.06, Rutherford County, Tennessee",2570,6,0.23,2564,27.27,"Census Tract 403.06, Rutherford County, Tennessee",3141,61,1.94,3080,30.19,"Census Tract 403.06, Rutherford County, Tennessee",3488,84,2.41,3404,28.61
957,47149042300,"Census Tract 423, Rutherford County, Tennessee",3754,134,3.57,3620,35.5,"Census Tract 423, Rutherford County, Tennessee",4387,102,2.33,4285,34.87,"Census Tract 423, Rutherford County, Tennessee",4956,85,1.72,4871,37.48
958,47149041301,"Census Tract 413.01, Rutherford County, Tennessee",2318,161,6.95,2157,29.03,"Census Tract 413.01, Rutherford County, Tennessee",2632,180,6.84,2452,31.39,"Census Tract 413.01, Rutherford County, Tennessee",2798,265,9.47,2533,32.29
959,47149041101,"Census Tract 411.01, Rutherford County, Tennessee",3812,84,2.2,3728,33.01,"Census Tract 411.01, Rutherford County, Tennessee",3956,159,4.02,3797,32.42,"Census Tract 411.01, Rutherford County, Tennessee",3944,154,3.9,3790,33.71
960,47149040702,"Census Tract 407.02, Rutherford County, Tennessee",2576,100,3.88,2476,39.53,"Census Tract 407.02, Rutherford County, Tennessee",2966,120,4.05,2846,40.41,"Census Tract 407.02, Rutherford County, Tennessee",3187,250,7.84,2937,37.87
961,47149040810,"Census Tract 408.10, Rutherford County, Tennessee",1109,36,3.25,1073,47.31,"Census Tract 408.10, Rutherford County, Tennessee",1134,44,3.88,1090,43.63,"Census Tract 408.10, Rutherford County, Tennessee",1417,96,6.77,1321,44.55
962,47149040701,"Census Tract 407.01, Rutherford County, Tennessee",4431,180,4.06,4251,35.7,"Census Tract 407.01, Rutherford County, Tennessee",5451,192,3.52,5259,36.52,"Census Tract 407.01, Rutherford County, Tennessee",6121,274,4.48,5847,35.63
963,47149040905,"Census Tract 409.05, Rutherford County, Tennessee",4473,184,4.11,4289,37.47,"Census Tract 409.05, Rutherford County, Tennessee",5302,240,4.53,5062,40.45,"Census Tract 409.05, Rutherford County, Tennessee",6075,363,5.98,5712,42.32
964,47149040901,"Census Tract 409.01, Rutherford County, Tennessee",1717,20,1.16,1697,31.7,"Census Tract 409.01, Rutherford County, Tennessee",1758,70,3.98,1688,35.11,"Census Tract 409.01, Rutherford County, Tennessee",2067,71,3.43,1996,31.48
965,47157020521,"Census Tract 205.21, Shelby County, Tennessee",1488,54,3.63,1434,26.45,"Census Tract 205.21, Shelby County, Tennessee",1414,54,3.82,1360,26.84,"Census Tract 205.21, Shelby County, Tennessee",1159,51,4.4,1108,27.86
966,47157008200,"Census Tract 82, Shelby County, Tennessee",1731,56,3.24,1675,28.94,"Census Tract 82, Shelby County, Tennessee",1441,65,4.51,1376,25.83,"Census Tract 82, Shelby County, Tennessee",1512,9,0.6,1503,29.71
967,47157010220,"Census Tract 102.20, Shelby County, Tennessee",2665,0,0.0,2665,26.64,"Census Tract 102.20, Shelby County, Tennessee",2844,0,0.0,2844,27.53,"Census Tract 102.20, Shelby County, Tennessee",2769,43,1.55,2726,25.21
968,47157020221,"Census Tract 202.21, Shelby County, Tennessee",1391,52,3.74,1339,30.37,"Census Tract 202.21, Shelby County, Tennessee",1284,54,4.21,1230,30.24,"Census Tract 202.21, Shelby County, Tennessee",1391,80,5.75,1311,28.0
969,47157021353,"Census Tract 213.53, Shelby County, Tennessee",4200,262,6.24,3938,27.94,"Census Tract 213.53, Shelby County, Tennessee",4217,235,5.57,3982,28.89,"Census Tract 213.53, Shelby County, Tennessee",4002,281,7.02,3721,26.66
970,47157021020,"Census Tract 210.20, Shelby County, Tennessee",3136,118,3.76,3018,32.47,"Census Tract 210.20, Shelby County, Tennessee",3157,96,3.04,3061,31.79,"Census Tract 210.20, Shelby County, Tennessee",3186,172,5.4,3014,32.66
971,47157021200,"Census Tract 212, Shelby County, Tennessee",0,0,,0,0.0,"Census Tract 212, Shelby County, Tennessee",0,0,,0,0.0,"Census Tract 212, Shelby County, Tennessee",0,0,,0,0.0
972,47157021342,"Census Tract 213.42, Shelby County, Tennessee",5276,133,2.52,5143,25.34,"Census Tract 213.42, Shelby County, Tennessee",5376,212,3.94,5164,25.39,"Census Tract 213.42, Shelby County, Tennessee",6080,448,7.37,5632,24.64
973,47157021710,"Census Tract 217.10, Shelby County, Tennessee",1400,0,0.0,1400,26.0,"Census Tract 217.10, Shelby County, Tennessee",1445,21,1.45,1424,24.32,"Census Tract 217.10, Shelby County, Tennessee",1541,28,1.82,1513,25.84
974,47157021745,"Census Tract 217.45, Shelby County, Tennessee",4342,0,0.0,4342,27.49,"Census Tract 217.45, Shelby County, Tennessee",4374,106,2.42,4268,30.74,"Census Tract 217.45, Shelby County, Tennessee",4795,146,3.04,4649,28.97
975,47157022210,"Census Tract 222.10, Shelby County, Tennessee",1393,100,7.18,1293,30.45,"Census Tract 222.10, Shelby County, Tennessee",1488,85,5.71,1403,33.08,"Census Tract 222.10, Shelby County, Tennessee",1357,62,4.57,1295,31.16
976,47061955200,"Census Tract 9552, Grundy County, Tennessee",1319,79,5.99,1240,43.66,"Census Tract 9552, Grundy County, Tennessee",1295,80,6.18,1215,38.3,"Census Tract 9552, Grundy County, Tennessee",1709,94,5.5,1615,40.88
977,47061955300,"Census Tract 9553, Grundy County, Tennessee",1749,96,5.49,1653,35.41,"Census Tract 9553, Grundy County, Tennessee",1526,97,6.36,1429,33.76,"Census Tract 9553, Grundy County, Tennessee",1823,168,9.22,1655,33.4
978,47061955000,"Census Tract 9550, Grundy County, Tennessee",854,74,8.67,780,34.39,"Census Tract 9550, Grundy County, Tennessee",796,59,7.41,737,33.21,"Census Tract 9550, Grundy County, Tennessee",834,44,5.28,790,31.87
979,47061955100,"Census Tract 9551, Grundy County, Tennessee",563,4,0.71,559,24.11,"Census Tract 9551, Grundy County, Tennessee",499,21,4.21,478,28.19,"Census Tract 9551, Grundy County, Tennessee",592,32,5.41,560,30.25
980,47099960800,"Census Tract 9608, Lawrence County, Tennessee",1516,25,1.65,1491,36.59,"Census Tract 9608, Lawrence County, Tennessee",1347,15,1.11,1332,37.68,"Census Tract 9608, Lawrence County, Tennessee",1406,27,1.92,1379,31.47
981,47099960900,"Census Tract 9609, Lawrence County, Tennessee",801,5,0.62,796,41.41,"Census Tract 9609, Lawrence County, Tennessee",797,3,0.38,794,41.51,"Census Tract 9609, Lawrence County, Tennessee",767,9,1.17,758,46.03
982,47099960300,"Census Tract 9603, Lawrence County, Tennessee",1966,208,10.58,1758,34.7,"Census Tract 9603, Lawrence County, Tennessee",1884,105,5.57,1779,34.44,"Census Tract 9603, Lawrence County, Tennessee",2070,143,6.91,1927,29.55
983,47099960200,"Census Tract 9602, Lawrence County, Tennessee",902,20,2.22,882,33.13,"Census Tract 9602, Lawrence County, Tennessee",1021,33,3.23,988,36.53,"Census Tract 9602, Lawrence County, Tennessee",1004,30,2.99,974,35.69
984,47163043202,"Census Tract 432.02, Sullivan County, Tennessee",2266,96,4.24,2170,32.02,"Census Tract 432.02, Sullivan County, Tennessee",2044,119,5.82,1925,30.25,"Census Tract 432.02, Sullivan County, Tennessee",1747,27,1.55,1720,35.25
985,47099960700,"Census Tract 9607, Lawrence County, Tennessee",1650,47,2.85,1603,26.45,"Census Tract 9607, Lawrence County, Tennessee",1652,15,0.91,1637,32.7,"Census Tract 9607, Lawrence County, Tennessee",1524,27,1.77,1497,34.84
986,47099960100,"Census Tract 9601, Lawrence County, Tennessee",2030,16,0.79,2014,35.33,"Census Tract 9601, Lawrence County, Tennessee",1664,9,0.54,1655,39.1,"Census Tract 9601, Lawrence County, Tennessee",1617,10,0.62,1607,38.67
987,47099960600,"Census Tract 9606, Lawrence County, Tennessee",919,10,1.09,909,42.18,"Census Tract 9606, Lawrence County, Tennessee",836,12,1.44,824,38.19,"Census Tract 9606, Lawrence County, Tennessee",788,50,6.35,738,41.76
988,47163043402,"Census Tract 434.02, Sullivan County, Tennessee",1824,43,2.36,1781,27.87,"Census Tract 434.02, Sullivan County, Tennessee",1933,64,3.31,1869,25.78,"Census Tract 434.02, Sullivan County, Tennessee",1725,62,3.59,1663,25.18
989,47163043401,"Census Tract 434.01, Sullivan County, Tennessee",2320,75,3.23,2245,28.96,"Census Tract 434.01, Sullivan County, Tennessee",2338,94,4.02,2244,28.6,"Census Tract 434.01, Sullivan County, Tennessee",2489,168,6.75,2321,26.59
990,47163043301,"Census Tract 433.01, Sullivan County, Tennessee",2586,110,4.25,2476,31.91,"Census Tract 433.01, Sullivan County, Tennessee",2417,151,6.25,2266,30.16,"Census Tract 433.01, Sullivan County, Tennessee",3164,125,3.95,3039,29.68
991,47163043500,"Census Tract 435, Sullivan County, Tennessee",1653,0,0.0,1653,28.61,"Census Tract 435, Sullivan County, Tennessee",1718,115,6.69,1603,28.22,"Census Tract 435, Sullivan County, Tennessee",1625,113,6.95,1512,28.24
992,47163040500,"Census Tract 405, Sullivan County, Tennessee",1534,49,3.19,1485,21.2,"Census Tract 405, Sullivan County, Tennessee",1656,54,3.26,1602,19.14,"Census Tract 405, Sullivan County, Tennessee",1698,69,4.06,1629,19.5
993,47147080200,"Census Tract 802, Robertson County, Tennessee",2839,96,3.38,2743,40.61,"Census Tract 802, Robertson County, Tennessee",3183,144,4.52,3039,37.98,"Census Tract 802, Robertson County, Tennessee",3024,137,4.53,2887,37.53
994,47041920200,"Census Tract 9202, DeKalb County, Tennessee",2366,12,0.51,2354,26.86,"Census Tract 9202, DeKalb County, Tennessee",2450,13,0.53,2437,29.22,"Census Tract 9202, DeKalb County, Tennessee",2141,14,0.65,2127,29.78
995,47041920300,"Census Tract 9203, DeKalb County, Tennessee",2290,114,4.98,2176,40.58,"Census Tract 9203, DeKalb County, Tennessee",2392,49,2.05,2343,43.14,"Census Tract 9203, DeKalb County, Tennessee",2387,42,1.76,2345,43.93
996,47163040300,"Census Tract 403, Sullivan County, Tennessee",1082,7,0.65,1075,18.34,"Census Tract 403, Sullivan County, Tennessee",1137,0,0.0,1137,19.66,"Census Tract 403, Sullivan County, Tennessee",1072,0,0.0,1072,20.15
997,47163042500,"Census Tract 425, Sullivan County, Tennessee",1367,10,0.73,1357,24.55,"Census Tract 425, Sullivan County, Tennessee",1534,27,1.76,1507,25.51,"Census Tract 425, Sullivan County, Tennessee",1535,33,2.15,1502,27.62
998,47163042200,"Census Tract 422, Sullivan County, Tennessee",1397,16,1.15,1381,29.31,"Census Tract 422, Sullivan County, Tennessee",1283,8,0.62,1275,27.57,"Census Tract 422, Sullivan County, Tennessee",1118,26,2.33,1092,27.78
999,47163042701,"Census Tract 427.01, Sullivan County, Tennessee",1942,20,1.03,1922,22.28,"Census Tract 427.01, Sullivan County, Tennessee",1769,16,0.9,1753,21.98,"Census Tract 427.01, Sullivan County, Tennessee",1870,26,1.39,1844,27.17
1000,47163043100,"Census Tract 431, Sullivan County, Tennessee",1163,38,3.27,1125,34.71,"Census Tract 431, Sullivan County, Tennessee",1082,66,6.1,1016,32.46,"Census Tract 431, Sullivan County, Tennessee",1240,72,5.81,1168,29.16
1001,47163042702,"Census Tract 427.02, Sullivan County, Tennessee",981,46,4.69,935,22.29,"Census Tract 427.02, Sullivan County, Tennessee",983,41,4.17,942,26.23,"Census Tract 427.02, Sullivan County, Tennessee",1030,54,5.24,976,23.08
1002,47163042000,"Census Tract 420, Sullivan County, Tennessee",1397,41,2.93,1356,29.79,"Census Tract 420, Sullivan County, Tennessee",1389,29,2.09,1360,29.94,"Census Tract 420, Sullivan County, Tennessee",1393,48,3.45,1345,24.41
1003,47163041200,"Census Tract 412, Sullivan County, Tennessee",2898,156,5.38,2742,24.07,"Census Tract 412, Sullivan County, Tennessee",2741,49,1.79,2692,25.63,"Census Tract 412, Sullivan County, Tennessee",2833,83,2.93,2750,25.83
1004,47163040700,"Census Tract 407, Sullivan County, Tennessee",1047,34,3.25,1013,18.3,"Census Tract 407, Sullivan County, Tennessee",1018,28,2.75,990,19.32,"Census Tract 407, Sullivan County, Tennessee",970,60,6.19,910,16.95
1005,47163042802,"Census Tract 428.02, Sullivan County, Tennessee",1625,97,5.97,1528,25.1,"Census Tract 428.02, Sullivan County, Tennessee",1816,128,7.05,1688,29.14,"Census Tract 428.02, Sullivan County, Tennessee",1908,113,5.92,1795,24.15
1006,47163041400,"Census Tract 414, Sullivan County, Tennessee",2068,0,0.0,2068,25.48,"Census Tract 414, Sullivan County, Tennessee",2307,81,3.51,2226,24.49,"Census Tract 414, Sullivan County, Tennessee",2209,109,4.93,2100,26.6
1007,47163041700,"Census Tract 417, Sullivan County, Tennessee",1153,9,0.78,1144,25.88,"Census Tract 417, Sullivan County, Tennessee",1060,22,2.08,1038,24.43,"Census Tract 417, Sullivan County, Tennessee",1259,30,2.38,1229,22.84
1008,47163040800,"Census Tract 408, Sullivan County, Tennessee",1145,57,4.98,1088,18.47,"Census Tract 408, Sullivan County, Tennessee",1213,48,3.96,1165,18.97,"Census Tract 408, Sullivan County, Tennessee",1386,48,3.46,1338,20.61
1009,47163041900,"Census Tract 419, Sullivan County, Tennessee",1336,29,2.17,1307,24.63,"Census Tract 419, Sullivan County, Tennessee",1344,47,3.5,1297,24.11,"Census Tract 419, Sullivan County, Tennessee",1253,41,3.27,1212,23.66
1010,47163041000,"Census Tract 410, Sullivan County, Tennessee",1873,132,7.05,1741,27.25,"Census Tract 410, Sullivan County, Tennessee",1949,75,3.85,1874,24.68,"Census Tract 410, Sullivan County, Tennessee",2001,49,2.45,1952,23.52
1011,47163040600,"Census Tract 406, Sullivan County, Tennessee",978,45,4.6,933,26.02,"Census Tract 406, Sullivan County, Tennessee",1127,15,1.33,1112,25.6,"Census Tract 406, Sullivan County, Tennessee",1063,17,1.6,1046,23.79
1012,47133950500,"Census Tract 9505, Overton County, Tennessee",2540,32,1.26,2508,30.35,"Census Tract 9505, Overton County, Tennessee",2630,19,0.72,2611,30.83,"Census Tract 9505, Overton County, Tennessee",3078,110,3.57,2968,32.14
1013,47163041100,"Census Tract 411, Sullivan County, Tennessee",999,0,0.0,999,21.3,"Census Tract 411, Sullivan County, Tennessee",985,55,5.58,930,19.21,"Census Tract 411, Sullivan County, Tennessee",1071,66,6.16,1005,21.04
1014,47163043600,"Census Tract 436, Sullivan County, Tennessee",2124,46,2.17,2078,24.2,"Census Tract 436, Sullivan County, Tennessee",2262,26,1.15,2236,24.25,"Census Tract 436, Sullivan County, Tennessee",2173,108,4.97,2065,25.75
1015,47163041300,"Census Tract 413, Sullivan County, Tennessee",1840,17,0.92,1823,24.33,"Census Tract 413, Sullivan County, Tennessee",1945,65,3.34,1880,23.85,"Census Tract 413, Sullivan County, Tennessee",2104,117,5.56,1987,23.91
1016,47133950400,"Census Tract 9504, Overton County, Tennessee",824,14,1.7,810,33.63,"Census Tract 9504, Overton County, Tennessee",896,11,1.23,885,37.08,"Census Tract 9504, Overton County, Tennessee",883,26,2.94,857,35.89
1017,47133950100,"Census Tract 9501, Overton County, Tennessee",655,46,7.02,609,38.46,"Census Tract 9501, Overton County, Tennessee",675,57,8.44,618,41.96,"Census Tract 9501, Overton County, Tennessee",598,47,7.86,551,48.24
1018,47133950600,"Census Tract 9506, Overton County, Tennessee",881,17,1.93,864,39.95,"Census Tract 9506, Overton County, Tennessee",887,10,1.13,877,37.78,"Census Tract 9506, Overton County, Tennessee",956,20,2.09,936,35.59
1019,47133950200,"Census Tract 9502, Overton County, Tennessee",779,4,0.51,775,43.0,"Census Tract 9502, Overton County, Tennessee",765,35,4.58,730,44.43,"Census Tract 9502, Overton County, Tennessee",773,52,6.73,721,39.78
1020,47077975500,"Census Tract 9755, Henderson County, Tennessee",1322,9,0.68,1313,27.59,"Census Tract 9755, Henderson County, Tennessee",1518,23,1.52,1495,30.96,"Census Tract 9755, Henderson County, Tennessee",1413,81,5.73,1332,33.49
1021,47037013400,"Census Tract 134, Davidson County, Tennessee",3051,292,9.57,2759,23.17,"Census Tract 134, Davidson County, Tennessee",2908,230,7.91,2678,24.14,"Census Tract 134, Davidson County, Tennessee",3009,187,6.21,2822,22.26
1022,47037017000,"Census Tract 170, Davidson County, Tennessee",1945,228,11.72,1717,18.41,"Census Tract 170, Davidson County, Tennessee",1982,188,9.49,1794,17.57,"Census Tract 170, Davidson County, Tennessee",2062,206,9.99,1856,19.53
1023,47173040100,"Census Tract 401, Union County, Tennessee",2509,47,1.87,2462,42.12,"Census Tract 401, Union County, Tennessee",2507,109,4.35,2398,41.58,"Census Tract 401, Union County, Tennessee",2547,133,5.22,2414,40.68
1024,47173040201,"Census Tract 402.01, Union County, Tennessee",1237,27,2.18,1210,41.17,"Census Tract 402.01, Union County, Tennessee",1431,27,1.89,1404,38.43,"Census Tract 402.01, Union County, Tennessee",1657,63,3.8,1594,40.65
1025,47173040300,"Census Tract 403, Union County, Tennessee",928,89,9.59,839,50.88,"Census Tract 403, Union County, Tennessee",912,91,9.98,821,47.55,"Census Tract 403, Union County, Tennessee",857,147,17.15,710,49.18
1026,47173040202,"Census Tract 402.02, Union County, Tennessee",1976,122,6.17,1854,40.6,"Census Tract 402.02, Union County, Tennessee",2262,143,6.32,2119,39.89,"Census Tract 402.02, Union County, Tennessee",2198,129,5.87,2069,39.12
1027,47187050906,"Census Tract 509.06, Williamson County, Tennessee",2790,172,6.16,2618,31.84,"Census Tract 509.06, Williamson County, Tennessee",2972,239,8.04,2733,30.9,"Census Tract 509.06, Williamson County, Tennessee",3012,336,11.16,2676,31.84
1028,47127930100,"Census Tract 9301, Moore County, Tennessee",1769,17,0.96,1752,27.95,"Census Tract 9301, Moore County, Tennessee",1635,6,0.37,1629,28.66,"Census Tract 9301, Moore County, Tennessee",1680,49,2.92,1631,32.58
1029,47001020600,"Census Tract 206, Anderson County, Tennessee",1207,43,3.56,1164,26.04,"Census Tract 206, Anderson County, Tennessee",1148,48,4.18,1100,25.53,"Census Tract 206, Anderson County, Tennessee",1074,65,6.05,1009,26.32
1030,47037010302,"Census Tract 103.02, Davidson County, Tennessee",803,39,4.86,764,27.99,"Census Tract 103.02, Davidson County, Tennessee",931,60,6.44,871,29.48,"Census Tract 103.02, Davidson County, Tennessee",1038,94,9.06,944,26.36
1031,47037010601,"Census Tract 106.01, Davidson County, Tennessee",2819,83,2.94,2736,31.63,"Census Tract 106.01, Davidson County, Tennessee",2781,114,4.1,2667,32.25,"Census Tract 106.01, Davidson County, Tennessee",2584,41,1.59,2543,34.22
1032,47037015624,"Census Tract 156.24, Davidson County, Tennessee",3007,98,3.26,2909,27.57,"Census Tract 156.24, Davidson County, Tennessee",3230,149,4.61,3081,33.78,"Census Tract 156.24, Davidson County, Tennessee",3433,245,7.14,3188,33.33
1033,47037015625,"Census Tract 156.25, Davidson County, Tennessee",3187,133,4.17,3054,28.61,"Census Tract 156.25, Davidson County, Tennessee",3290,209,6.35,3081,28.06,"Census Tract 156.25, Davidson County, Tennessee",3281,294,8.96,2987,30.73
1034,47073050800,"Census Tract 508, Hawkins County, Tennessee",1737,10,0.58,1727,31.77,"Census Tract 508, Hawkins County, Tennessee",1583,48,3.03,1535,30.8,"Census Tract 508, Hawkins County, Tennessee",1698,47,2.77,1651,32.45
1035,47073050200,"Census Tract 502, Hawkins County, Tennessee",1352,13,0.96,1339,34.66,"Census Tract 502, Hawkins County, Tennessee",1498,0,0.0,1498,42.06,"Census Tract 502, Hawkins County, Tennessee",1569,0,0.0,1569,41.62
1036,47073050301,"Census Tract 503.01, Hawkins County, Tennessee",1612,19,1.18,1593,23.97,"Census Tract 503.01, Hawkins County, Tennessee",1353,41,3.03,1312,23.97,"Census Tract 503.01, Hawkins County, Tennessee",1714,57,3.33,1657,26.73
1037,47077975000,"Census Tract 9750, Henderson County, Tennessee",1252,31,2.48,1221,33.03,"Census Tract 9750, Henderson County, Tennessee",1329,38,2.86,1291,27.29,"Census Tract 9750, Henderson County, Tennessee",1406,18,1.28,1388,29.17
1038,47077975300,"Census Tract 9753, Henderson County, Tennessee",3311,136,4.11,3175,26.85,"Census Tract 9753, Henderson County, Tennessee",3266,114,3.49,3152,30.52,"Census Tract 9753, Henderson County, Tennessee",3314,155,4.68,3159,28.1
1039,47077975400,"Census Tract 9754, Henderson County, Tennessee",1232,27,2.19,1205,28.7,"Census Tract 9754, Henderson County, Tennessee",1331,20,1.5,1311,29.3,"Census Tract 9754, Henderson County, Tennessee",1678,87,5.18,1591,32.03
1040,47077975100,"Census Tract 9751, Henderson County, Tennessee",1772,90,5.08,1682,28.58,"Census Tract 9751, Henderson County, Tennessee",1656,62,3.74,1594,32.25,"Census Tract 9751, Henderson County, Tennessee",1392,84,6.03,1308,34.65
1041,47077975200,"Census Tract 9752, Henderson County, Tennessee",2094,34,1.62,2060,34.41,"Census Tract 9752, Henderson County, Tennessee",2100,152,7.24,1948,36.74,"Census Tract 9752, Henderson County, Tennessee",1993,161,8.08,1832,38.02
1042,47189030401,"Census Tract 304.01, Wilson County, Tennessee",1084,33,3.04,1051,28.98,"Census Tract 304.01, Wilson County, Tennessee",1158,78,6.74,1080,30.06,"Census Tract 304.01, Wilson County, Tennessee",1131,59,5.22,1072,31.12
1043,47189030204,"Census Tract 302.04, Wilson County, Tennessee",3106,149,4.8,2957,37.71,"Census Tract 302.04, Wilson County, Tennessee",3471,152,4.38,3319,39.96,"Census Tract 302.04, Wilson County, Tennessee",3949,273,6.91,3676,44.58
1044,47189030203,"Census Tract 302.03, Wilson County, Tennessee",2511,106,4.22,2405,36.69,"Census Tract 302.03, Wilson County, Tennessee",2701,130,4.81,2571,39.1,"Census Tract 302.03, Wilson County, Tennessee",3219,294,9.13,2925,39.8
1045,47189030402,"Census Tract 304.02, Wilson County, Tennessee",2267,0,0.0,2267,22.44,"Census Tract 304.02, Wilson County, Tennessee",1932,8,0.41,1924,26.7,"Census Tract 304.02, Wilson County, Tennessee",2114,27,1.28,2087,27.8
1046,47189030904,"Census Tract 309.04, Wilson County, Tennessee",1660,91,5.48,1569,45.41,"Census Tract 309.04, Wilson County, Tennessee",1914,79,4.13,1835,44.54,"Census Tract 309.04, Wilson County, Tennessee",2302,143,6.21,2159,40.17
1047,47189030903,"Census Tract 309.03, Wilson County, Tennessee",3868,147,3.8,3721,32.7,"Census Tract 309.03, Wilson County, Tennessee",4109,383,9.32,3726,38.9,"Census Tract 309.03, Wilson County, Tennessee",4882,462,9.46,4420,42.07
1048,47037014400,"Census Tract 144, Davidson County, Tennessee",550,12,2.18,538,28.35,"Census Tract 144, Davidson County, Tennessee",644,21,3.26,623,28.36,"Census Tract 144, Davidson County, Tennessee",1069,101,9.45,968,22.53
1049,47111970200,"Census Tract 9702, Macon County, Tennessee",2429,29,1.19,2400,38.89,"Census Tract 9702, Macon County, Tennessee",2547,33,1.3,2514,40.57,"Census Tract 9702, Macon County, Tennessee",2734,62,2.27,2672,37.05
1050,47111970400,"Census Tract 9704, Macon County, Tennessee",1613,55,3.41,1558,40.17,"Census Tract 9704, Macon County, Tennessee",1714,41,2.39,1673,40.63,"Census Tract 9704, Macon County, Tennessee",2098,56,2.67,2042,41.4
1051,47111970100,"Census Tract 9701, Macon County, Tennessee",1886,76,4.03,1810,40.43,"Census Tract 9701, Macon County, Tennessee",1849,93,5.03,1756,45.58,"Census Tract 9701, Macon County, Tennessee",2018,96,4.76,1922,44.35
1052,47111970300,"Census Tract 9703, Macon County, Tennessee",3415,17,0.5,3398,38.86,"Census Tract 9703, Macon County, Tennessee",3386,32,0.95,3354,40.86,"Census Tract 9703, Macon County, Tennessee",3497,117,3.35,3380,37.87
1053,47011011401,"Census Tract 114.01, Bradley County, Tennessee",3601,102,2.83,3499,24.22,"Census Tract 114.01, Bradley County, Tennessee",3724,107,2.87,3617,24.28,"Census Tract 114.01, Bradley County, Tennessee",3893,178,4.57,3715,25.7
1054,47011011602,"Census Tract 116.02, Bradley County, Tennessee",2015,10,0.5,2005,30.14,"Census Tract 116.02, Bradley County, Tennessee",2041,51,2.5,1990,34.16,"Census Tract 116.02, Bradley County, Tennessee",2131,66,3.1,2065,33.24
1055,47011011402,"Census Tract 114.02, Bradley County, Tennessee",1281,65,5.07,1216,23.21,"Census Tract 114.02, Bradley County, Tennessee",1299,84,6.47,1215,23.05,"Census Tract 114.02, Bradley County, Tennessee",1389,79,5.69,1310,23.09
1056,47011011601,"Census Tract 116.01, Bradley County, Tennessee",2032,131,6.45,1901,27.77,"Census Tract 116.01, Bradley County, Tennessee",2003,31,1.55,1972,29.73,"Census Tract 116.01, Bradley County, Tennessee",2144,15,0.7,2129,28.99
1057,47175925200,"Census Tract 9252, Van Buren County, Tennessee",1153,101,8.76,1052,32.73,"Census Tract 9252, Van Buren County, Tennessee",1190,79,6.64,1111,31.33,"Census Tract 9252, Van Buren County, Tennessee",1083,50,4.62,1033,34.87
1058,47175925000,"Census Tract 9250, Van Buren County, Tennessee",1011,57,5.64,954,34.16,"Census Tract 9250, Van Buren County, Tennessee",1032,94,9.11,938,35.74,"Census Tract 9250, Van Buren County, Tennessee",996,84,8.43,912,40.38
1059,47093003300,"Census Tract 33, Knox County, Tennessee",1118,44,3.94,1074,26.87,"Census Tract 33, Knox County, Tennessee",1111,52,4.68,1059,25.76,"Census Tract 33, Knox County, Tennessee",1115,47,4.22,1068,27.99
1060,47093002100,"Census Tract 21, Knox County, Tennessee",896,0,0.0,896,29.48,"Census Tract 21, Knox County, Tennessee",1080,7,0.65,1073,28.47,"Census Tract 21, Knox County, Tennessee",1245,42,3.37,1203,26.78
1061,47093002600,"Census Tract 26, Knox County, Tennessee",999,0,0.0,999,20.67,"Census Tract 26, Knox County, Tennessee",1005,16,1.59,989,21.23,"Census Tract 26, Knox County, Tennessee",1050,18,1.71,1032,21.46
1062,47093004100,"Census Tract 41, Knox County, Tennessee",2300,15,0.65,2285,23.57,"Census Tract 41, Knox County, Tennessee",2263,38,1.68,2225,23.17,"Census Tract 41, Knox County, Tennessee",2381,75,3.15,2306,24.02
1063,47093004800,"Census Tract 48, Knox County, Tennessee",2546,87,3.42,2459,27.46,"Census Tract 48, Knox County, Tennessee",2804,232,8.27,2572,26.26,"Census Tract 48, Knox County, Tennessee",2552,134,5.25,2418,28.5
1064,47093006202,"Census Tract 62.02, Knox County, Tennessee",2522,105,4.16,2417,30.74,"Census Tract 62.02, Knox County, Tennessee",2533,72,2.84,2461,30.57,"Census Tract 62.02, Knox County, Tennessee",2453,96,3.91,2357,32.11
1065,47037019004,"Census Tract 190.04, Davidson County, Tennessee",1946,19,0.98,1927,26.94,"Census Tract 190.04, Davidson County, Tennessee",2071,92,4.44,1979,29.62,"Census Tract 190.04, Davidson County, Tennessee",2276,123,5.4,2153,33.11
1066,47037015404,"Census Tract 154.04, Davidson County, Tennessee",1339,25,1.87,1314,26.74,"Census Tract 154.04, Davidson County, Tennessee",1451,28,1.93,1423,32.94,"Census Tract 154.04, Davidson County, Tennessee",1405,30,2.14,1375,36.29
1067,47037018801,"Census Tract 188.01, Davidson County, Tennessee",3240,341,10.52,2899,29.23,"Census Tract 188.01, Davidson County, Tennessee",3317,475,14.32,2842,30.48,"Census Tract 188.01, Davidson County, Tennessee",3270,371,11.35,2899,31.14
1068,47037011001,"Census Tract 110.01, Davidson County, Tennessee",2101,36,1.71,2065,29.97,"Census Tract 110.01, Davidson County, Tennessee",2467,134,5.43,2333,30.97,"Census Tract 110.01, Davidson County, Tennessee",2988,243,8.13,2745,30.34
1069,47037017200,"Census Tract 172, Davidson County, Tennessee",830,40,4.82,790,22.3,"Census Tract 172, Davidson County, Tennessee",892,67,7.51,825,21.1,"Census Tract 172, Davidson County, Tennessee",936,77,8.23,859,19.89
1070,47037015700,"Census Tract 157, Davidson County, Tennessee",750,13,1.73,737,27.01,"Census Tract 157, Davidson County, Tennessee",836,34,4.07,802,27.25,"Census Tract 157, Davidson County, Tennessee",951,38,4.0,913,27.31
1071,47037018202,"Census Tract 182.02, Davidson County, Tennessee",4443,319,7.18,4124,30.19,"Census Tract 182.02, Davidson County, Tennessee",4751,280,5.89,4471,31.48,"Census Tract 182.02, Davidson County, Tennessee",4201,243,5.78,3958,29.72
1072,47037015900,"Census Tract 159, Davidson County, Tennessee",1023,75,7.33,948,24.31,"Census Tract 159, Davidson County, Tennessee",1026,46,4.48,980,24.81,"Census Tract 159, Davidson County, Tennessee",1100,36,3.27,1064,22.9
1073,47037012702,"Census Tract 127.02, Davidson County, Tennessee",1086,5,0.46,1081,28.82,"Census Tract 127.02, Davidson County, Tennessee",1148,14,1.22,1134,25.06,"Census Tract 127.02, Davidson County, Tennessee",1231,12,0.97,1219,24.76
1074,47037019114,"Census Tract 191.14, Davidson County, Tennessee",7070,347,4.91,6723,32.6,"Census Tract 191.14, Davidson County, Tennessee",7258,946,13.03,6312,33.86,"Census Tract 191.14, Davidson County, Tennessee",8645,1167,13.5,7478,36.36
1075,47037010401,"Census Tract 104.01, Davidson County, Tennessee",2464,35,1.42,2429,31.14,"Census Tract 104.01, Davidson County, Tennessee",2227,56,2.51,2171,32.0,"Census Tract 104.01, Davidson County, Tennessee",2441,42,1.72,2399,32.39
1076,47143975300,"Census Tract 9753, Rhea County, Tennessee",2035,93,4.57,1942,29.99,"Census Tract 9753, Rhea County, Tennessee",1864,161,8.64,1703,29.92,"Census Tract 9753, Rhea County, Tennessee",2030,125,6.16,1905,30.73
1077,47037017800,"Census Tract 178, Davidson County, Tennessee",3587,126,3.51,3461,21.41,"Census Tract 178, Davidson County, Tennessee",3815,195,5.11,3620,22.4,"Census Tract 178, Davidson County, Tennessee",3731,342,9.17,3389,23.03
1078,47037019109,"Census Tract 191.09, Davidson County, Tennessee",2937,35,1.19,2902,30.11,"Census Tract 191.09, Davidson County, Tennessee",2824,23,0.81,2801,31.02,"Census Tract 191.09, Davidson County, Tennessee",2588,85,3.28,2503,31.58
1079,47037017500,"Census Tract 175, Davidson County, Tennessee",1413,35,2.48,1378,22.38,"Census Tract 175, Davidson County, Tennessee",1579,32,2.03,1547,22.88,"Census Tract 175, Davidson County, Tennessee",1440,42,2.92,1398,24.11
1080,47037015613,"Census Tract 156.13, Davidson County, Tennessee",1989,13,0.65,1976,25.05,"Census Tract 156.13, Davidson County, Tennessee",2140,130,6.07,2010,26.24,"Census Tract 156.13, Davidson County, Tennessee",2063,162,7.85,1901,27.68
1081,47143975200,"Census Tract 9752, Rhea County, Tennessee",2413,0,0.0,2413,25.88,"Census Tract 9752, Rhea County, Tennessee",2700,28,1.04,2672,29.87,"Census Tract 9752, Rhea County, Tennessee",2942,78,2.65,2864,30.65
1082,47143975000,"Census Tract 9750, Rhea County, Tennessee",2125,106,4.99,2019,37.96,"Census Tract 9750, Rhea County, Tennessee",1917,94,4.9,1823,36.37,"Census Tract 9750, Rhea County, Tennessee",1769,76,4.3,1693,36.66
1083,47143975100,"Census Tract 9751, Rhea County, Tennessee",1810,90,4.97,1720,32.55,"Census Tract 9751, Rhea County, Tennessee",2133,83,3.89,2050,32.05,"Census Tract 9751, Rhea County, Tennessee",1802,57,3.16,1745,32.51
1084,47093003801,"Census Tract 38.01, Knox County, Tennessee",2486,32,1.29,2454,23.64,"Census Tract 38.01, Knox County, Tennessee",2428,39,1.61,2389,21.54,"Census Tract 38.01, Knox County, Tennessee",3051,113,3.7,2938,21.89
1085,47011010800,"Census Tract 108, Bradley County, Tennessee",1095,11,1.0,1084,27.78,"Census Tract 108, Bradley County, Tennessee",1128,39,3.46,1089,20.86,"Census Tract 108, Bradley County, Tennessee",1201,37,3.08,1164,21.07
1086,47011010400,"Census Tract 104, Bradley County, Tennessee",1012,35,3.46,977,20.34,"Census Tract 104, Bradley County, Tennessee",1075,8,0.74,1067,18.89,"Census Tract 104, Bradley County, Tennessee",1163,5,0.43,1158,19.27
1087,47037010301,"Census Tract 103.01, Davidson County, Tennessee",1627,97,5.96,1530,25.96,"Census Tract 103.01, Davidson County, Tennessee",1800,64,3.56,1736,27.99,"Census Tract 103.01, Davidson County, Tennessee",1538,40,2.6,1498,33.06
1088,47037010402,"Census Tract 104.02, Davidson County, Tennessee",1937,69,3.56,1868,30.26,"Census Tract 104.02, Davidson County, Tennessee",2450,143,5.84,2307,34.7,"Census Tract 104.02, Davidson County, Tennessee",3057,112,3.66,2945,34.67
1089,47037010802,"Census Tract 108.02, Davidson County, Tennessee",1685,89,5.28,1596,24.74,"Census Tract 108.02, Davidson County, Tennessee",1695,187,11.03,1508,30.81,"Census Tract 108.02, Davidson County, Tennessee",1753,103,5.88,1650,30.11
1090,47037010904,"Census Tract 109.04, Davidson County, Tennessee",1119,0,0.0,1119,25.97,"Census Tract 109.04, Davidson County, Tennessee",1268,13,1.03,1255,29.48,"Census Tract 109.04, Davidson County, Tennessee",1408,18,1.28,1390,34.85
1091,47037011002,"Census Tract 110.02, Davidson County, Tennessee",1404,108,7.69,1296,24.31,"Census Tract 110.02, Davidson County, Tennessee",1320,107,8.11,1213,24.15,"Census Tract 110.02, Davidson County, Tennessee",1530,117,7.65,1413,27.23
1092,47037011100,"Census Tract 111, Davidson County, Tennessee",2228,217,9.74,2011,27.86,"Census Tract 111, Davidson County, Tennessee",2535,340,13.41,2195,27.87,"Census Tract 111, Davidson County, Tennessee",2518,365,14.5,2153,30.65
1093,47037015614,"Census Tract 156.14, Davidson County, Tennessee",2537,8,0.32,2529,29.97,"Census Tract 156.14, Davidson County, Tennessee",2658,27,1.02,2631,28.34,"Census Tract 156.14, Davidson County, Tennessee",2435,72,2.96,2363,28.99
1094,47037017300,"Census Tract 173, Davidson County, Tennessee",1498,30,2.0,1468,24.46,"Census Tract 173, Davidson County, Tennessee",1998,99,4.95,1899,23.61,"Census Tract 173, Davidson County, Tennessee",2052,134,6.53,1918,22.75
1095,47189030308,"Census Tract 303.08, Wilson County, Tennessee",2440,61,2.5,2379,37.12,"Census Tract 303.08, Wilson County, Tennessee",2463,139,5.64,2324,38.27,"Census Tract 303.08, Wilson County, Tennessee",2720,254,9.34,2466,40.07
1096,47037015622,"Census Tract 156.22, Davidson County, Tennessee",1865,32,1.72,1833,31.73,"Census Tract 156.22, Davidson County, Tennessee",2396,107,4.47,2289,33.16,"Census Tract 156.22, Davidson County, Tennessee",2695,314,11.65,2381,35.25
1097,47037019006,"Census Tract 190.06, Davidson County, Tennessee",2296,100,4.36,2196,27.02,"Census Tract 190.06, Davidson County, Tennessee",2516,100,3.97,2416,30.64,"Census Tract 190.06, Davidson County, Tennessee",2312,64,2.77,2248,30.62
1098,47037019117,"Census Tract 191.17, Davidson County, Tennessee",2510,78,3.11,2432,33.51,"Census Tract 191.17, Davidson County, Tennessee",2580,87,3.37,2493,38.24,"Census Tract 191.17, Davidson County, Tennessee",2828,122,4.31,2706,38.76
1099,47037018803,"Census Tract 188.03, Davidson County, Tennessee",2032,105,5.17,1927,23.73,"Census Tract 188.03, Davidson County, Tennessee",1841,147,7.98,1694,24.06,"Census Tract 188.03, Davidson County, Tennessee",2247,188,8.37,2059,26.31
1100,47031970500,"Census Tract 9705, Coffee County, Tennessee",2393,65,2.72,2328,25.73,"Census Tract 9705, Coffee County, Tennessee",2403,74,3.08,2329,24.64,"Census Tract 9705, Coffee County, Tennessee",2429,99,4.08,2330,28.37
1101,47157020622,"Census Tract 206.22, Shelby County, Tennessee",1815,34,1.87,1781,28.15,"Census Tract 206.22, Shelby County, Tennessee",1841,83,4.51,1758,28.8,"Census Tract 206.22, Shelby County, Tennessee",1995,86,4.31,1909,29.0
1102,47157020632,"Census Tract 206.32, Shelby County, Tennessee",2643,168,6.36,2475,26.49,"Census Tract 206.32, Shelby County, Tennessee",2613,101,3.87,2512,28.9,"Census Tract 206.32, Shelby County, Tennessee",2951,117,3.96,2834,29.19
1103,47157020651,"Census Tract 206.51, Shelby County, Tennessee",3136,0,0.0,3136,26.96,"Census Tract 206.51, Shelby County, Tennessee",3272,149,4.55,3123,26.58,"Census Tract 206.51, Shelby County, Tennessee",3325,183,5.5,3142,26.25
1104,47019071200,"Census Tract 712, Carter County, Tennessee",1629,126,7.73,1503,25.3,"Census Tract 712, Carter County, Tennessee",1554,87,5.6,1467,24.77,"Census Tract 712, Carter County, Tennessee",1502,42,2.8,1460,28.25
1105,47019071400,"Census Tract 714, Carter County, Tennessee",1257,125,9.94,1132,31.87,"Census Tract 714, Carter County, Tennessee",1180,75,6.36,1105,34.93,"Census Tract 714, Carter County, Tennessee",1152,15,1.3,1137,32.92
1106,47019071700,"Census Tract 717, Carter County, Tennessee",1376,20,1.45,1356,35.71,"Census Tract 717, Carter County, Tennessee",1481,5,0.34,1476,39.42,"Census Tract 717, Carter County, Tennessee",1459,21,1.44,1438,36.97
1107,47019070600,"Census Tract 706, Carter County, Tennessee",1141,40,3.51,1101,25.21,"Census Tract 706, Carter County, Tennessee",924,20,2.16,904,22.66,"Census Tract 706, Carter County, Tennessee",811,31,3.82,780,26.67
1108,47155081101,"Census Tract 811.01, Sevier County, Tennessee",781,17,2.18,764,20.34,"Census Tract 811.01, Sevier County, Tennessee",992,30,3.02,962,19.75,"Census Tract 811.01, Sevier County, Tennessee",864,44,5.09,820,19.27
1109,47155081102,"Census Tract 811.02, Sevier County, Tennessee",1753,103,5.88,1650,23.57,"Census Tract 811.02, Sevier County, Tennessee",1458,37,2.54,1421,21.68,"Census Tract 811.02, Sevier County, Tennessee",1669,98,5.87,1571,20.84
1110,47157022322,"Census Tract 223.22, Shelby County, Tennessee",1474,11,0.75,1463,33.31,"Census Tract 223.22, Shelby County, Tennessee",1694,0,0.0,1694,32.39,"Census Tract 223.22, Shelby County, Tennessee",1505,0,0.0,1505,25.52
1111,47037017702,"Census Tract 177.02, Davidson County, Tennessee",2619,314,11.99,2305,19.69,"Census Tract 177.02, Davidson County, Tennessee",2624,194,7.39,2430,20.03,"Census Tract 177.02, Davidson County, Tennessee",2662,189,7.1,2473,18.87
1112,47037017701,"Census Tract 177.01, Davidson County, Tennessee",1228,61,4.97,1167,22.29,"Census Tract 177.01, Davidson County, Tennessee",1299,104,8.01,1195,22.99,"Census Tract 177.01, Davidson County, Tennessee",1327,177,13.34,1150,24.48
1113,47037018804,"Census Tract 188.04, Davidson County, Tennessee",2749,153,5.57,2596,26.11,"Census Tract 188.04, Davidson County, Tennessee",2672,195,7.3,2477,27.8,"Census Tract 188.04, Davidson County, Tennessee",3031,289,9.53,2742,32.53
1114,47037019118,"Census Tract 191.18, Davidson County, Tennessee",3107,150,4.83,2957,29.98,"Census Tract 191.18, Davidson County, Tennessee",3923,195,4.97,3728,31.34,"Census Tract 191.18, Davidson County, Tennessee",3853,122,3.17,3731,32.32
1115,47017962201,"Census Tract 9622.01, Carroll County, Tennessee",1050,9,0.86,1041,27.22,"Census Tract 9622.01, Carroll County, Tennessee",1112,17,1.53,1095,30.51,"Census Tract 9622.01, Carroll County, Tennessee",1060,27,2.55,1033,29.13
1116,47017962202,"Census Tract 9622.02, Carroll County, Tennessee",1952,57,2.92,1895,24.66,"Census Tract 9622.02, Carroll County, Tennessee",2318,101,4.36,2217,25.22,"Census Tract 9622.02, Carroll County, Tennessee",2227,70,3.14,2157,29.55
1117,47017980100,"Census Tract 9801, Carroll County, Tennessee",0,0,,0,0.0,"Census Tract 9801, Carroll County, Tennessee",0,0,,0,0.0,"Census Tract 9801, Carroll County, Tennessee",0,0,,0,0.0
1118,47099960402,"Census Tract 9604.02, Lawrence County, Tennessee",1522,46,3.02,1476,30.56,"Census Tract 9604.02, Lawrence County, Tennessee",1675,21,1.25,1654,37.18,"Census Tract 9604.02, Lawrence County, Tennessee",1840,71,3.86,1769,32.35
1119,47099960502,"Census Tract 9605.02, Lawrence County, Tennessee",1659,39,2.35,1620,32.78,"Census Tract 9605.02, Lawrence County, Tennessee",1853,51,2.75,1802,32.18,"Census Tract 9605.02, Lawrence County, Tennessee",1938,67,3.46,1871,28.73
1120,47099960501,"Census Tract 9605.01, Lawrence County, Tennessee",1269,53,4.18,1216,25.76,"Census Tract 9605.01, Lawrence County, Tennessee",1266,21,1.66,1245,26.69,"Census Tract 9605.01, Lawrence County, Tennessee",1271,29,2.28,1242,24.32
1121,47099960401,"Census Tract 9604.01, Lawrence County, Tennessee",1859,58,3.12,1801,25.34,"Census Tract 9604.01, Lawrence County, Tennessee",1801,25,1.39,1776,26.39,"Census Tract 9604.01, Lawrence County, Tennessee",2174,72,3.31,2102,29.4
1122,47003950402,"Census Tract 9504.02, Bedford County, Tennessee",2634,53,2.01,2581,29.6,"Census Tract 9504.02, Bedford County, Tennessee",2708,56,2.07,2652,27.34,"Census Tract 9504.02, Bedford County, Tennessee",2751,142,5.16,2609,30.08
1123,47003950401,"Census Tract 9504.01, Bedford County, Tennessee",2325,73,3.14,2252,29.95,"Census Tract 9504.01, Bedford County, Tennessee",2461,101,4.1,2360,31.68,"Census Tract 9504.01, Bedford County, Tennessee",2749,84,3.06,2665,30.46
1124,47125102004,"Census Tract 1020.04, Montgomery County, Tennessee",2427,38,1.57,2389,28.74,"Census Tract 1020.04, Montgomery County, Tennessee",2981,67,2.25,2914,28.93,"Census Tract 1020.04, Montgomery County, Tennessee",3123,47,1.5,3076,28.16
1125,47125101803,"Census Tract 1018.03, Montgomery County, Tennessee",2998,60,2.0,2938,32.34,"Census Tract 1018.03, Montgomery County, Tennessee",2897,59,2.04,2838,36.47,"Census Tract 1018.03, Montgomery County, Tennessee",3083,100,3.24,2983,39.55
1126,47157020652,"Census Tract 206.52, Shelby County, Tennessee",2782,159,5.72,2623,27.64,"Census Tract 206.52, Shelby County, Tennessee",2430,171,7.04,2259,30.95,"Census Tract 206.52, Shelby County, Tennessee",2500,152,6.08,2348,31.18
1127,47157021111,"Census Tract 211.11, Shelby County, Tennessee",2124,4,0.19,2120,29.63,"Census Tract 211.11, Shelby County, Tennessee",2086,17,0.81,2069,27.95,"Census Tract 211.11, Shelby County, Tennessee",1999,20,1.0,1979,29.07
1128,47157021112,"Census Tract 211.12, Shelby County, Tennessee",3489,54,1.55,3435,28.05,"Census Tract 211.12, Shelby County, Tennessee",3367,69,2.05,3298,27.24,"Census Tract 211.12, Shelby County, Tennessee",3042,96,3.16,2946,33.62
1129,47157021113,"Census Tract 211.13, Shelby County, Tennessee",2006,15,0.75,1991,25.89,"Census Tract 211.13, Shelby County, Tennessee",1961,19,0.97,1942,23.44,"Census Tract 211.13, Shelby County, Tennessee",2084,63,3.02,2021,24.72
1130,47065012000,"Census Tract 120, Hamilton County, Tennessee",747,54,7.23,693,24.08,"Census Tract 120, Hamilton County, Tennessee",860,86,10.0,774,23.6,"Census Tract 120, Hamilton County, Tennessee",846,68,8.04,778,23.43
1131,47157022330,"Census Tract 223.30, Shelby County, Tennessee",1702,0,0.0,1702,29.65,"Census Tract 223.30, Shelby County, Tennessee",1849,20,1.08,1829,26.8,"Census Tract 223.30, Shelby County, Tennessee",1928,25,1.3,1903,27.99
1132,47157006300,"Census Tract 63, Shelby County, Tennessee",1616,59,3.65,1557,25.46,"Census Tract 63, Shelby County, Tennessee",1689,57,3.37,1632,23.89,"Census Tract 63, Shelby County, Tennessee",1685,77,4.57,1608,20.42
1133,47157021122,"Census Tract 211.22, Shelby County, Tennessee",2698,0,0.0,2698,28.24,"Census Tract 211.22, Shelby County, Tennessee",2940,104,3.54,2836,28.42,"Census Tract 211.22, Shelby County, Tennessee",3254,207,6.36,3047,23.99
1134,47157005000,"Census Tract 50, Shelby County, Tennessee",229,0,0.0,229,31.08,"Census Tract 50, Shelby County, Tennessee",233,0,0.0,233,27.8,"Census Tract 50, Shelby County, Tennessee",193,0,0.0,193,25.45
1135,47157021136,"Census Tract 211.36, Shelby County, Tennessee",2818,164,5.82,2654,31.01,"Census Tract 211.36, Shelby County, Tennessee",2929,173,5.91,2756,34.25,"Census Tract 211.36, Shelby County, Tennessee",2931,185,6.31,2746,31.13
1136,47157021137,"Census Tract 211.37, Shelby County, Tennessee",3930,198,5.04,3732,27.07,"Census Tract 211.37, Shelby County, Tennessee",3968,154,3.88,3814,28.63,"Census Tract 211.37, Shelby County, Tennessee",4282,67,1.56,4215,30.2
1137,47157021530,"Census Tract 215.30, Shelby County, Tennessee",2549,148,5.81,2401,28.3,"Census Tract 215.30, Shelby County, Tennessee",2449,100,4.08,2349,30.06,"Census Tract 215.30, Shelby County, Tennessee",2543,144,5.66,2399,29.97
1138,47157021611,"Census Tract 216.11, Shelby County, Tennessee",3453,52,1.51,3401,30.02,"Census Tract 216.11, Shelby County, Tennessee",3515,219,6.23,3296,28.78,"Census Tract 216.11, Shelby County, Tennessee",3519,209,5.94,3310,27.59
1139,47177930100,"Census Tract 9301, Warren County, Tennessee",1590,9,0.57,1581,29.38,"Census Tract 9301, Warren County, Tennessee",1657,35,2.11,1622,29.1,"Census Tract 9301, Warren County, Tennessee",1730,47,2.72,1683,31.68
1140,47177930300,"Census Tract 9303, Warren County, Tennessee",1184,73,6.17,1111,41.0,"Census Tract 9303, Warren County, Tennessee",1091,49,4.49,1042,42.97,"Census Tract 9303, Warren County, Tennessee",1109,81,7.3,1028,41.41
1141,47177930500,"Census Tract 9305, Warren County, Tennessee",1680,95,5.65,1585,25.92,"Census Tract 9305, Warren County, Tennessee",1812,100,5.52,1712,27.75,"Census Tract 9305, Warren County, Tennessee",1718,27,1.57,1691,28.53
1142,47177930800,"Census Tract 9308, Warren County, Tennessee",2327,84,3.61,2243,32.16,"Census Tract 9308, Warren County, Tennessee",2312,78,3.37,2234,32.54,"Census Tract 9308, Warren County, Tennessee",2454,40,1.63,2414,28.53
1143,47177930200,"Census Tract 9302, Warren County, Tennessee",2595,55,2.12,2540,34.63,"Census Tract 9302, Warren County, Tennessee",2738,78,2.85,2660,33.97,"Census Tract 9302, Warren County, Tennessee",3055,60,1.96,2995,31.76
1144,47177930400,"Census Tract 9304, Warren County, Tennessee",2605,0,0.0,2605,22.22,"Census Tract 9304, Warren County, Tennessee",2746,82,2.99,2664,26.62,"Census Tract 9304, Warren County, Tennessee",2438,95,3.9,2343,31.31
1145,47177930900,"Census Tract 9309, Warren County, Tennessee",544,36,6.62,508,36.49,"Census Tract 9309, Warren County, Tennessee",631,52,8.24,579,32.87,"Census Tract 9309, Warren County, Tennessee",702,24,3.42,678,32.25
1146,47177930700,"Census Tract 9307, Warren County, Tennessee",2245,118,5.26,2127,23.56,"Census Tract 9307, Warren County, Tennessee",2320,87,3.75,2233,24.18,"Census Tract 9307, Warren County, Tennessee",2206,67,3.04,2139,22.42
1147,47177930600,"Census Tract 9306, Warren County, Tennessee",1341,58,4.33,1283,30.94,"Census Tract 9306, Warren County, Tennessee",1560,58,3.72,1502,29.46,"Census Tract 9306, Warren County, Tennessee",1525,73,4.79,1452,29.35
1148,47155080700,"Census Tract 807, Sevier County, Tennessee",3467,227,6.55,3240,34.99,"Census Tract 807.00, Sevier County, Tennessee",3389,254,7.49,3135,32.96,"Census Tract 807.00, Sevier County, Tennessee",3573,244,6.83,3329,31.68
1149,47079969600,"Census Tract 9696, Henry County, Tennessee",3138,134,4.27,3004,24.37,"Census Tract 9696, Henry County, Tennessee",3240,128,3.95,3112,24.35,"Census Tract 9696, Henry County, Tennessee",3384,30,0.89,3354,24.2
1150,47131965400,"Census Tract 9654, Obion County, Tennessee",1830,6,0.33,1824,23.06,"Census Tract 9654, Obion County, Tennessee",1736,28,1.61,1708,24.04,"Census Tract 9654, Obion County, Tennessee",1867,47,2.52,1820,22.83
1151,47157004300,"Census Tract 43, Shelby County, Tennessee",1009,54,5.35,955,22.48,"Census Tract 43, Shelby County, Tennessee",1305,54,4.14,1251,25.43,"Census Tract 43, Shelby County, Tennessee",1997,163,8.16,1834,26.2
1152,47131965800,"Census Tract 9658, Obion County, Tennessee",829,51,6.15,778,26.47,"Census Tract 9658, Obion County, Tennessee",809,78,9.64,731,21.1,"Census Tract 9658, Obion County, Tennessee",804,58,7.21,746,19.27
1153,47131965300,"Census Tract 9653, Obion County, Tennessee",1471,61,4.15,1410,32.72,"Census Tract 9653, Obion County, Tennessee",1656,30,1.81,1626,33.74,"Census Tract 9653, Obion County, Tennessee",1639,33,2.01,1606,34.98
1154,47131965700,"Census Tract 9657, Obion County, Tennessee",1916,52,2.71,1864,17.87,"Census Tract 9657, Obion County, Tennessee",1912,64,3.35,1848,19.79,"Census Tract 9657, Obion County, Tennessee",1812,13,0.72,1799,20.62
1155,47131965600,"Census Tract 9656, Obion County, Tennessee",1296,13,1.0,1283,21.24,"Census Tract 9656, Obion County, Tennessee",1264,0,0.0,1264,22.39,"Census Tract 9656, Obion County, Tennessee",1380,41,2.97,1339,22.45
1156,47131965200,"Census Tract 9652, Obion County, Tennessee",995,37,3.72,958,26.57,"Census Tract 9652, Obion County, Tennessee",859,33,3.84,826,24.38,"Census Tract 9652, Obion County, Tennessee",894,27,3.02,867,22.81
1157,47131965900,"Census Tract 9659, Obion County, Tennessee",439,25,5.69,414,24.63,"Census Tract 9659, Obion County, Tennessee",500,32,6.4,468,31.4,"Census Tract 9659, Obion County, Tennessee",536,16,2.99,520,32.12
1158,47131965000,"Census Tract 9650, Obion County, Tennessee",1860,37,1.99,1823,23.09,"Census Tract 9650, Obion County, Tennessee",1734,45,2.6,1689,25.89,"Census Tract 9650, Obion County, Tennessee",1783,54,3.03,1729,25.43
1159,47131965100,"Census Tract 9651, Obion County, Tennessee",978,9,0.92,969,24.98,"Census Tract 9651, Obion County, Tennessee",912,20,2.19,892,24.67,"Census Tract 9651, Obion County, Tennessee",905,43,4.75,862,18.0
1160,47131965500,"Census Tract 9655, Obion County, Tennessee",794,9,1.13,785,24.09,"Census Tract 9655, Obion County, Tennessee",925,10,1.08,915,27.24,"Census Tract 9655, Obion County, Tennessee",995,0,0.0,995,23.86
1161,47019070200,"Census Tract 702, Carter County, Tennessee",1921,77,4.01,1844,20.47,"Census Tract 702, Carter County, Tennessee",1695,80,4.72,1615,20.06,"Census Tract 702, Carter County, Tennessee",1738,125,7.19,1613,21.12
1162,47065011700,"Census Tract 117, Hamilton County, Tennessee",2148,215,10.01,1933,20.43,"Census Tract 117, Hamilton County, Tennessee",2425,203,8.37,2222,20.74,"Census Tract 117, Hamilton County, Tennessee",2266,73,3.22,2193,20.48
1163,47157009901,"Census Tract 99.01, Shelby County, Tennessee",1266,94,7.42,1172,27.91,"Census Tract 99.01, Shelby County, Tennessee",1214,22,1.81,1192,29.21,"Census Tract 99.01, Shelby County, Tennessee",1172,25,2.13,1147,28.02
1164,47157020644,"Census Tract 206.44, Shelby County, Tennessee",4815,28,0.58,4787,28.7,"Census Tract 206.44, Shelby County, Tennessee",5100,143,2.8,4957,30.23,"Census Tract 206.44, Shelby County, Tennessee",5184,194,3.74,4990,30.63
1165,47157020643,"Census Tract 206.43, Shelby County, Tennessee",3958,83,2.1,3875,29.72,"Census Tract 206.43, Shelby County, Tennessee",4165,130,3.12,4035,30.45,"Census Tract 206.43, Shelby County, Tennessee",4420,109,2.47,4311,28.29
1166,47157021334,"Census Tract 213.34, Shelby County, Tennessee",2035,54,2.65,1981,23.44,"Census Tract 213.34, Shelby County, Tennessee",2098,16,0.76,2082,23.98,"Census Tract 213.34, Shelby County, Tennessee",2261,42,1.86,2219,22.75
1167,47157021333,"Census Tract 213.33, Shelby County, Tennessee",2137,73,3.42,2064,24.09,"Census Tract 213.33, Shelby County, Tennessee",2395,126,5.26,2269,22.81,"Census Tract 213.33, Shelby County, Tennessee",2635,93,3.53,2542,25.47
1168,47157021139,"Census Tract 211.39, Shelby County, Tennessee",2113,92,4.35,2021,31.64,"Census Tract 211.39, Shelby County, Tennessee",2082,95,4.56,1987,32.32,"Census Tract 211.39, Shelby County, Tennessee",2227,168,7.54,2059,30.61
1169,47157022500,"Census Tract 225, Shelby County, Tennessee",2062,0,0.0,2062,27.5,"Census Tract 225, Shelby County, Tennessee",1885,25,1.33,1860,27.18,"Census Tract 225, Shelby County, Tennessee",1969,31,1.57,1938,24.76
1170,47157020531,"Census Tract 205.31, Shelby County, Tennessee",2602,62,2.38,2540,28.66,"Census Tract 205.31, Shelby County, Tennessee",2898,29,1.0,2869,29.16,"Census Tract 205.31, Shelby County, Tennessee",2347,28,1.19,2319,28.34
1171,47157020532,"Census Tract 205.32, Shelby County, Tennessee",2243,43,1.92,2200,27.04,"Census Tract 205.32, Shelby County, Tennessee",2896,62,2.14,2834,27.16,"Census Tract 205.32, Shelby County, Tennessee",3221,38,1.18,3183,28.31
1172,47157020832,"Census Tract 208.32, Shelby County, Tennessee",4788,312,6.52,4476,30.31,"Census Tract 208.32, Shelby County, Tennessee",4589,338,7.37,4251,30.36,"Census Tract 208.32, Shelby County, Tennessee",4364,172,3.94,4192,29.1
1173,47157021142,"Census Tract 211.42, Shelby County, Tennessee",2339,41,1.75,2298,29.5,"Census Tract 211.42, Shelby County, Tennessee",2416,47,1.95,2369,28.62,"Census Tract 211.42, Shelby County, Tennessee",2504,34,1.36,2470,29.74
1174,47157011700,"Census Tract 117, Shelby County, Tennessee",395,0,0.0,395,26.42,"Census Tract 117, Shelby County, Tennessee",338,0,0.0,338,24.52,"Census Tract 117, Shelby County, Tennessee",286,18,6.29,268,26.59
1175,47119010202,"Census Tract 102.02, Maury County, Tennessee",4716,281,5.96,4435,42.54,"Census Tract 102.02, Maury County, Tennessee",5227,223,4.27,5004,36.75,"Census Tract 102.02, Maury County, Tennessee",5632,288,5.11,5344,37.44
1176,47119010301,"Census Tract 103.01, Maury County, Tennessee",3575,191,5.34,3384,43.28,"Census Tract 103.01, Maury County, Tennessee",3110,156,5.02,2954,38.0,"Census Tract 103.01, Maury County, Tennessee",3842,220,5.73,3622,36.89
1177,47119011101,"Census Tract 111.01, Maury County, Tennessee",2144,48,2.24,2096,36.71,"Census Tract 111.01, Maury County, Tennessee",2128,86,4.04,2042,32.61,"Census Tract 111.01, Maury County, Tennessee",2315,185,7.99,2130,32.16
1178,47119011001,"Census Tract 110.01, Maury County, Tennessee",1240,27,2.18,1213,28.48,"Census Tract 110.01, Maury County, Tennessee",1389,17,1.22,1372,33.94,"Census Tract 110.01, Maury County, Tennessee",1445,26,1.8,1419,35.48
1179,47035970603,"Census Tract 9706.03, Cumberland County, Tennessee",978,42,4.29,936,25.91,"Census Tract 9706.03, Cumberland County, Tennessee",799,38,4.76,761,25.41,"Census Tract 9706.03, Cumberland County, Tennessee",775,23,2.97,752,28.97
1180,47035970702,"Census Tract 9707.02, Cumberland County, Tennessee",1298,0,0.0,1298,26.93,"Census Tract 9707.02, Cumberland County, Tennessee",1528,61,3.99,1467,33.45,"Census Tract 9707.02, Cumberland County, Tennessee",1752,69,3.94,1683,36.18
1181,47035970502,"Census Tract 9705.02, Cumberland County, Tennessee",1293,25,1.93,1268,18.54,"Census Tract 9705.02, Cumberland County, Tennessee",1424,26,1.83,1398,20.02,"Census Tract 9705.02, Cumberland County, Tennessee",1656,21,1.27,1635,21.77
1182,47035970101,"Census Tract 9701.01, Cumberland County, Tennessee",587,63,10.73,524,32.03,"Census Tract 9701.01, Cumberland County, Tennessee",630,63,10.0,567,25.7,"Census Tract 9701.01, Cumberland County, Tennessee",679,134,19.73,545,28.45
1183,47035970102,"Census Tract 9701.02, Cumberland County, Tennessee",1701,37,2.18,1664,22.64,"Census Tract 9701.02, Cumberland County, Tennessee",1514,65,4.29,1449,23.83,"Census Tract 9701.02, Cumberland County, Tennessee",1690,95,5.62,1595,24.54
1184,47035970602,"Census Tract 9706.02, Cumberland County, Tennessee",1311,31,2.36,1280,26.08,"Census Tract 9706.02, Cumberland County, Tennessee",1450,46,3.17,1404,27.86,"Census Tract 9706.02, Cumberland County, Tennessee",1593,20,1.26,1573,28.62
1185,47035970601,"Census Tract 9706.01, Cumberland County, Tennessee",1973,69,3.5,1904,27.32,"Census Tract 9706.01, Cumberland County, Tennessee",1962,50,2.55,1912,23.15,"Census Tract 9706.01, Cumberland County, Tennessee",2118,43,2.03,2075,23.19
1186,47035970301,"Census Tract 9703.01, Cumberland County, Tennessee",1285,88,6.85,1197,26.92,"Census Tract 9703.01, Cumberland County, Tennessee",1143,66,5.77,1077,28.83,"Census Tract 9703.01, Cumberland County, Tennessee",1142,28,2.45,1114,34.89
1187,47035970302,"Census Tract 9703.02, Cumberland County, Tennessee",1463,10,0.68,1453,30.83,"Census Tract 9703.02, Cumberland County, Tennessee",1462,18,1.23,1444,32.39,"Census Tract 9703.02, Cumberland County, Tennessee",1481,128,8.64,1353,28.94
1188,47035970701,"Census Tract 9707.01, Cumberland County, Tennessee",764,5,0.65,759,35.86,"Census Tract 9707.01, Cumberland County, Tennessee",863,8,0.93,855,26.29,"Census Tract 9707.01, Cumberland County, Tennessee",856,30,3.5,826,29.62
1189,47035970501,"Census Tract 9705.01, Cumberland County, Tennessee",1106,67,6.06,1039,23.07,"Census Tract 9705.01, Cumberland County, Tennessee",1064,20,1.88,1044,24.06,"Census Tract 9705.01, Cumberland County, Tennessee",933,12,1.29,921,25.87
1190,47153060102,"Census Tract 601.02, Sequatchie County, Tennessee",766,40,5.22,726,48.36,"Census Tract 601.02, Sequatchie County, Tennessee",788,45,5.71,743,48.97,"Census Tract 601.02, Sequatchie County, Tennessee",800,29,3.62,771,48.17
1191,47153060101,"Census Tract 601.01, Sequatchie County, Tennessee",3046,14,0.46,3032,37.4,"Census Tract 601.01, Sequatchie County, Tennessee",3102,57,1.84,3045,36.66,"Census Tract 601.01, Sequatchie County, Tennessee",3312,115,3.47,3197,39.05
1192,47145980100,"Census Tract 9801, Roane County, Tennessee",0,0,,0,0.0,"Census Tract 9801, Roane County, Tennessee",0,0,,0,0.0,"Census Tract 9801, Roane County, Tennessee",0,0,,0,0.0
1193,47057500402,"Census Tract 5004.02, Grainger County, Tennessee",1727,136,7.87,1591,35.1,"Census Tract 5004.02, Grainger County, Tennessee",1828,172,9.41,1656,38.29,"Census Tract 5004.02, Grainger County, Tennessee",1869,142,7.6,1727,38.28
1194,47057500401,"Census Tract 5004.01, Grainger County, Tennessee",1023,12,1.17,1011,34.89,"Census Tract 5004.01, Grainger County, Tennessee",1021,0,0.0,1021,34.96,"Census Tract 5004.01, Grainger County, Tennessee",844,0,0.0,844,31.65
1195,47093000902,"Census Tract 9.02, Knox County, Tennessee",1033,129,12.49,904,16.85,"Census Tract 9.02, Knox County, Tennessee",1161,185,15.93,976,18.58,"Census Tract 9.02, Knox County, Tennessee",1018,236,23.18,782,18.87
1196,47093004607,"Census Tract 46.07, Knox County, Tennessee",3191,186,5.83,3005,24.64,"Census Tract 46.07, Knox County, Tennessee",3151,160,5.08,2991,26.22,"Census Tract 46.07, Knox County, Tennessee",3272,173,5.29,3099,28.43
1197,47093004615,"Census Tract 46.15, Knox County, Tennessee",1820,20,1.1,1800,26.75,"Census Tract 46.15, Knox County, Tennessee",1917,14,0.73,1903,23.56,"Census Tract 46.15, Knox County, Tennessee",2077,57,2.74,2020,23.54
1198,47093003901,"Census Tract 39.01, Knox County, Tennessee",2418,10,0.41,2408,22.0,"Census Tract 39.01, Knox County, Tennessee",2377,80,3.37,2297,23.42,"Census Tract 39.01, Knox County, Tennessee",2095,129,6.16,1966,24.93
1199,47093005302,"Census Tract 53.02, Knox County, Tennessee",1581,99,6.26,1482,28.32,"Census Tract 53.02, Knox County, Tennessee",1958,199,10.16,1759,31.45,"Census Tract 53.02, Knox County, Tennessee",2054,160,7.79,1894,32.1
1200,47093005502,"Census Tract 55.02, Knox County, Tennessee",1330,75,5.64,1255,25.72,"Census Tract 55.02, Knox County, Tennessee",1497,70,4.68,1427,27.83,"Census Tract 55.02, Knox County, Tennessee",1581,103,6.51,1478,26.23
1201,47093005603,"Census Tract 56.03, Knox County, Tennessee",1932,119,6.16,1813,28.63,"Census Tract 56.03, Knox County, Tennessee",2006,52,2.59,1954,31.06,"Census Tract 56.03, Knox County, Tennessee",1994,70,3.51,1924,29.19
1202,47093004404,"Census Tract 44.04, Knox County, Tennessee",1966,63,3.2,1903,23.86,"Census Tract 44.04, Knox County, Tennessee",1792,108,6.03,1684,21.94,"Census Tract 44.04, Knox County, Tennessee",2127,126,5.92,2001,22.39
1203,47093005301,"Census Tract 53.01, Knox County, Tennessee",1922,142,7.39,1780,27.99,"Census Tract 53.01, Knox County, Tennessee",1993,165,8.28,1828,29.69,"Census Tract 53.01, Knox County, Tennessee",2047,145,7.08,1902,29.98
1204,47093006502,"Census Tract 65.02, Knox County, Tennessee",1278,22,1.72,1256,32.74,"Census Tract 65.02, Knox County, Tennessee",1460,101,6.92,1359,32.98,"Census Tract 65.02, Knox County, Tennessee",1597,73,4.57,1524,31.89
1205,47093004613,"Census Tract 46.13, Knox County, Tennessee",2661,193,7.25,2468,24.41,"Census Tract 46.13, Knox County, Tennessee",2880,166,5.76,2714,23.78,"Census Tract 46.13, Knox County, Tennessee",2894,159,5.49,2735,23.86
1206,47093006002,"Census Tract 60.02, Knox County, Tennessee",2885,76,2.63,2809,24.31,"Census Tract 60.02, Knox County, Tennessee",3134,257,8.2,2877,26.74,"Census Tract 60.02, Knox County, Tennessee",3035,220,7.25,2815,29.45
1207,47093004610,"Census Tract 46.10, Knox County, Tennessee",2825,83,2.94,2742,19.75,"Census Tract 46.10, Knox County, Tennessee",2754,129,4.68,2625,19.66,"Census Tract 46.10, Knox County, Tennessee",3019,105,3.48,2914,21.06
1208,47157020900,"Census Tract 209, Shelby County, Tennessee",4667,188,4.03,4479,35.0,"Census Tract 209, Shelby County, Tennessee",5074,179,3.53,4895,35.06,"Census Tract 209, Shelby County, Tennessee",5019,256,5.1,4763,36.39
1209,47093006401,"Census Tract 64.01, Knox County, Tennessee",2006,25,1.25,1981,32.64,"Census Tract 64.01, Knox County, Tennessee",2035,0,0.0,2035,35.6,"Census Tract 64.01, Knox County, Tennessee",2087,13,0.62,2074,37.44
1210,47093006600,"Census Tract 66, Knox County, Tennessee",1631,74,4.54,1557,23.47,"Census Tract 66, Knox County, Tennessee",1653,112,6.78,1541,25.24,"Census Tract 66, Knox County, Tennessee",1700,167,9.82,1533,26.27
1211,47093006800,"Census Tract 68, Knox County, Tennessee",1558,20,1.28,1538,29.0,"Census Tract 68, Knox County, Tennessee",1700,44,2.59,1656,28.02,"Census Tract 68, Knox County, Tennessee",1770,86,4.86,1684,26.49
1212,47133950302,"Census Tract 9503.02, Overton County, Tennessee",1162,22,1.89,1140,26.32,"Census Tract 9503.02, Overton County, Tennessee",1147,31,2.7,1116,28.81,"Census Tract 9503.02, Overton County, Tennessee",1232,13,1.06,1219,29.26
1213,47133950301,"Census Tract 9503.01, Overton County, Tennessee",1538,72,4.68,1466,28.53,"Census Tract 9503.01, Overton County, Tennessee",1599,95,5.94,1504,29.29,"Census Tract 9503.01, Overton County, Tennessee",1672,82,4.9,1590,28.49
1214,47157021121,"Census Tract 211.21, Shelby County, Tennessee",2901,20,0.69,2881,27.09,"Census Tract 211.21, Shelby County, Tennessee",3030,15,0.5,3015,24.41,"Census Tract 211.21, Shelby County, Tennessee",2970,20,0.67,2950,24.89
1215,47157010300,"Census Tract 103, Shelby County, Tennessee",502,5,1.0,497,34.0,"Census Tract 103, Shelby County, Tennessee",491,5,1.02,486,32.32,"Census Tract 103, Shelby County, Tennessee",407,3,0.74,404,28.6
1216,47157020700,"Census Tract 207, Shelby County, Tennessee",1134,28,2.47,1106,35.02,"Census Tract 207, Shelby County, Tennessee",1031,30,2.91,1001,37.34,"Census Tract 207, Shelby County, Tennessee",983,51,5.19,932,38.28
1217,47157021010,"Census Tract 210.10, Shelby County, Tennessee",9446,257,2.72,9189,34.2,"Census Tract 210.10, Shelby County, Tennessee",9703,258,2.66,9445,35.59,"Census Tract 210.10, Shelby County, Tennessee",10284,256,2.49,10028,37.1
1218,47157021510,"Census Tract 215.10, Shelby County, Tennessee",4293,130,3.03,4163,26.64,"Census Tract 215.10, Shelby County, Tennessee",4532,129,2.85,4403,26.79,"Census Tract 215.10, Shelby County, Tennessee",4811,163,3.39,4648,26.07
1219,47157020621,"Census Tract 206.21, Shelby County, Tennessee",3260,0,0.0,3260,22.14,"Census Tract 206.21, Shelby County, Tennessee",3747,0,0.0,3747,24.56,"Census Tract 206.21, Shelby County, Tennessee",4401,53,1.2,4348,23.95
1220,47157021744,"Census Tract 217.44, Shelby County, Tennessee",3069,80,2.61,2989,30.78,"Census Tract 217.44, Shelby County, Tennessee",3209,96,2.99,3113,28.56,"Census Tract 217.44, Shelby County, Tennessee",3231,69,2.14,3162,27.83
1221,47003950700,"Census Tract 9507, Bedford County, Tennessee",1174,40,3.41,1134,34.54,"Census Tract 9507, Bedford County, Tennessee",1230,42,3.41,1188,32.68,"Census Tract 9507, Bedford County, Tennessee",1294,48,3.71,1246,30.72
1222,47157010500,"Census Tract 105, Shelby County, Tennessee",476,0,0.0,476,25.25,"Census Tract 105, Shelby County, Tennessee",418,8,1.91,410,23.66,"Census Tract 105, Shelby County, Tennessee",510,14,2.75,496,26.25
1223,47157004500,"Census Tract 45, Shelby County, Tennessee",161,9,5.59,152,27.09,"Census Tract 45, Shelby County, Tennessee",252,0,0.0,252,29.12,"Census Tract 45, Shelby County, Tennessee",290,0,0.0,290,25.42
1224,47157980300,"Census Tract 9803, Shelby County, Tennessee",0,0,,0,0.0,"Census Tract 9803, Shelby County, Tennessee",0,0,,0,0.0,"Census Tract 9803, Shelby County, Tennessee",0,0,,0,0.0
1225,47157021724,"Census Tract 217.24, Shelby County, Tennessee",1269,13,1.02,1256,25.07,"Census Tract 217.24, Shelby County, Tennessee",1324,8,0.6,1316,24.55,"Census Tract 217.24, Shelby County, Tennessee",1208,19,1.57,1189,25.01
1226,47157980100,"Census Tract 9801, Shelby County, Tennessee",12,0,0.0,12,44.0,"Census Tract 9801, Shelby County, Tennessee",0,0,,0,0.0,"Census Tract 9801, Shelby County, Tennessee",4,0,0.0,4,14.0
1227,47065011900,"Census Tract 119, Hamilton County, Tennessee",1010,4,0.4,1006,20.85,"Census Tract 119, Hamilton County, Tennessee",911,19,2.09,892,19.86,"Census Tract 119, Hamilton County, Tennessee",725,36,4.97,689,19.73
1228,47003950600,"Census Tract 9506, Bedford County, Tennessee",2942,37,1.26,2905,22.74,"Census Tract 9506, Bedford County, Tennessee",2920,44,1.51,2876,23.64,"Census Tract 9506, Bedford County, Tennessee",3499,190,5.43,3309,24.37
1229,47003950100,"Census Tract 9501, Bedford County, Tennessee",1827,144,7.88,1683,35.76,"Census Tract 9501, Bedford County, Tennessee",1979,186,9.4,1793,34.25,"Census Tract 9501, Bedford County, Tennessee",2054,115,5.6,1939,32.65
1230,47003950300,"Census Tract 9503, Bedford County, Tennessee",1533,82,5.35,1451,36.97,"Census Tract 9503, Bedford County, Tennessee",1591,50,3.14,1541,36.83,"Census Tract 9503, Bedford County, Tennessee",1439,54,3.75,1385,36.59
1231,47003950500,"Census Tract 9505, Bedford County, Tennessee",2519,84,3.33,2435,23.97,"Census Tract 9505, Bedford County, Tennessee",3227,87,2.7,3140,27.43,"Census Tract 9505, Bedford County, Tennessee",2908,0,0.0,2908,28.68
1232,47003950800,"Census Tract 9508, Bedford County, Tennessee",1357,9,0.66,1348,32.86,"Census Tract 9508, Bedford County, Tennessee",1548,37,2.39,1511,29.16,"Census Tract 9508, Bedford County, Tennessee",1612,31,1.92,1581,27.26
1233,47003950200,"Census Tract 9502, Bedford County, Tennessee",3176,138,4.35,3038,39.41,"Census Tract 9502, Bedford County, Tennessee",3331,123,3.69,3208,37.92,"Census Tract 9502, Bedford County, Tennessee",3305,91,2.75,3214,38.35
1234,47065011326,"Census Tract 113.26, Hamilton County, Tennessee",2393,134,5.6,2259,27.35,"Census Tract 113.26, Hamilton County, Tennessee",2878,125,4.34,2753,24.78,"Census Tract 113.26, Hamilton County, Tennessee",3645,79,2.17,3566,24.35
1235,47123925502,"Census Tract 9255.02, Monroe County, Tennessee",1978,45,2.28,1933,44.96,"Census Tract 9255.02, Monroe County, Tennessee",1903,11,0.58,1892,46.0,"Census Tract 9255.02, Monroe County, Tennessee",1937,8,0.41,1929,51.09
1236,47123925501,"Census Tract 9255.01, Monroe County, Tennessee",862,44,5.1,818,40.85,"Census Tract 9255.01, Monroe County, Tennessee",1158,71,6.13,1087,40.71,"Census Tract 9255.01, Monroe County, Tennessee",974,113,11.6,861,45.44
1237,47119010700,"Census Tract 107, Maury County, Tennessee",1690,0,0.0,1690,26.22,"Census Tract 107, Maury County, Tennessee",2014,48,2.38,1966,30.18,"Census Tract 107, Maury County, Tennessee",1955,90,4.6,1865,37.09
1238,47141000303,"Census Tract 3.03, Putnam County, Tennessee",1194,26,2.18,1168,25.82,"Census Tract 3.03, Putnam County, Tennessee",1075,33,3.07,1042,27.83,"Census Tract 3.03, Putnam County, Tennessee",893,6,0.67,887,23.07
1239,47157004200,"Census Tract 42, Shelby County, Tennessee",2157,16,0.74,2141,23.81,"Census Tract 42, Shelby County, Tennessee",2407,64,2.66,2343,23.15,"Census Tract 42, Shelby County, Tennessee",2664,140,5.26,2524,23.63
1240,47157004600,"Census Tract 46, Shelby County, Tennessee",613,13,2.12,600,25.56,"Census Tract 46, Shelby County, Tennessee",592,17,2.87,575,25.13,"Census Tract 46, Shelby County, Tennessee",477,9,1.89,468,23.09
1241,47107970300,"Census Tract 9703, McMinn County, Tennessee",1473,23,1.56,1450,22.73,"Census Tract 9703, McMinn County, Tennessee",1342,18,1.34,1324,24.12,"Census Tract 9703, McMinn County, Tennessee",1321,46,3.48,1275,25.73
1242,47107970500,"Census Tract 9705, McMinn County, Tennessee",1304,19,1.46,1285,31.02,"Census Tract 9705, McMinn County, Tennessee",1290,28,2.17,1262,32.91,"Census Tract 9705, McMinn County, Tennessee",1596,30,1.88,1566,27.91
1243,47107970800,"Census Tract 9708, McMinn County, Tennessee",2654,130,4.9,2524,34.75,"Census Tract 9708, McMinn County, Tennessee",3016,96,3.18,2920,31.8,"Census Tract 9708, McMinn County, Tennessee",2957,202,6.83,2755,30.17
1244,47107970200,"Census Tract 9702, McMinn County, Tennessee",1841,55,2.99,1786,21.87,"Census Tract 9702, McMinn County, Tennessee",1762,26,1.48,1736,26.0,"Census Tract 9702, McMinn County, Tennessee",1893,77,4.07,1816,26.28
1245,47107970700,"Census Tract 9707, McMinn County, Tennessee",1750,104,5.94,1646,32.57,"Census Tract 9707, McMinn County, Tennessee",1596,131,8.21,1465,33.37,"Census Tract 9707, McMinn County, Tennessee",1381,79,5.72,1302,28.56
1246,47107970600,"Census Tract 9706, McMinn County, Tennessee",2484,92,3.7,2392,31.76,"Census Tract 9706, McMinn County, Tennessee",2672,131,4.9,2541,30.13,"Census Tract 9706, McMinn County, Tennessee",2412,88,3.65,2324,29.28
1247,47065010901,"Census Tract 109.01, Hamilton County, Tennessee",1183,71,6.0,1112,18.39,"Census Tract 109.01, Hamilton County, Tennessee",1198,74,6.18,1124,19.05,"Census Tract 109.01, Hamilton County, Tennessee",1238,51,4.12,1187,20.1
1248,47065010902,"Census Tract 109.02, Hamilton County, Tennessee",403,57,14.14,346,26.68,"Census Tract 109.02, Hamilton County, Tennessee",414,34,8.21,380,25.16,"Census Tract 109.02, Hamilton County, Tennessee",479,30,6.26,449,26.37
1249,47065010903,"Census Tract 109.03, Hamilton County, Tennessee",2877,97,3.37,2780,23.51,"Census Tract 109.03, Hamilton County, Tennessee",3066,65,2.12,3001,23.54,"Census Tract 109.03, Hamilton County, Tennessee",3227,114,3.53,3113,24.1
1250,47065011443,"Census Tract 114.43, Hamilton County, Tennessee",2902,96,3.31,2806,21.77,"Census Tract 114.43, Hamilton County, Tennessee",2929,98,3.35,2831,23.77,"Census Tract 114.43, Hamilton County, Tennessee",2676,146,5.46,2530,26.47
1251,47065010305,"Census Tract 103.05, Hamilton County, Tennessee",1360,43,3.16,1317,28.53,"Census Tract 103.05, Hamilton County, Tennessee",1491,50,3.35,1441,33.35,"Census Tract 103.05, Hamilton County, Tennessee",1670,60,3.59,1610,34.97
1252,47065010104,"Census Tract 101.04, Hamilton County, Tennessee",2216,54,2.44,2162,39.81,"Census Tract 101.04, Hamilton County, Tennessee",1959,65,3.32,1894,42.47,"Census Tract 101.04, Hamilton County, Tennessee",1595,72,4.51,1523,44.79
1253,47065011002,"Census Tract 110.02, Hamilton County, Tennessee",3418,119,3.48,3299,29.84,"Census Tract 110.02, Hamilton County, Tennessee",3671,228,6.21,3443,30.98,"Census Tract 110.02, Hamilton County, Tennessee",3543,271,7.65,3272,33.87
1254,47065010103,"Census Tract 101.03, Hamilton County, Tennessee",1965,28,1.42,1937,31.54,"Census Tract 101.03, Hamilton County, Tennessee",1953,10,0.51,1943,31.76,"Census Tract 101.03, Hamilton County, Tennessee",1836,28,1.53,1808,34.03
1255,47065010303,"Census Tract 103.03, Hamilton County, Tennessee",1637,35,2.14,1602,31.49,"Census Tract 103.03, Hamilton County, Tennessee",1508,50,3.32,1458,30.8,"Census Tract 103.03, Hamilton County, Tennessee",1493,31,2.08,1462,31.13
1256,47065011001,"Census Tract 110.01, Hamilton County, Tennessee",735,8,1.09,727,35.48,"Census Tract 110.01, Hamilton County, Tennessee",659,9,1.37,650,37.47,"Census Tract 110.01, Hamilton County, Tennessee",707,44,6.22,663,37.99
1257,47065010435,"Census Tract 104.35, Hamilton County, Tennessee",2566,118,4.6,2448,23.92,"Census Tract 104.35, Hamilton County, Tennessee",2212,85,3.84,2127,22.71,"Census Tract 104.35, Hamilton County, Tennessee",2304,135,5.86,2169,33.31
1258,47065011325,"Census Tract 113.25, Hamilton County, Tennessee",2805,221,7.88,2584,25.99,"Census Tract 113.25, Hamilton County, Tennessee",2805,232,8.27,2573,30.31,"Census Tract 113.25, Hamilton County, Tennessee",2734,359,13.13,2375,31.12
1259,47119010900,"Census Tract 109, Maury County, Tennessee",1439,43,2.99,1396,35.14,"Census Tract 109, Maury County, Tennessee",1666,27,1.62,1639,40.72,"Census Tract 109, Maury County, Tennessee",1550,111,7.16,1439,41.53
1260,47119010400,"Census Tract 104, Maury County, Tennessee",2565,139,5.42,2426,30.44,"Census Tract 104, Maury County, Tennessee",3038,131,4.31,2907,39.12,"Census Tract 104, Maury County, Tennessee",3122,168,5.38,2954,42.96
1261,47119010500,"Census Tract 105, Maury County, Tennessee",1834,0,0.0,1834,28.78,"Census Tract 105, Maury County, Tennessee",1581,2,0.13,1579,30.42,"Census Tract 105, Maury County, Tennessee",1894,14,0.74,1880,32.84
1262,47119011200,"Census Tract 112, Maury County, Tennessee",2696,85,3.15,2611,38.16,"Census Tract 112, Maury County, Tennessee",2579,57,2.21,2522,41.95,"Census Tract 112, Maury County, Tennessee",2868,102,3.56,2766,40.53
1263,47119010600,"Census Tract 106, Maury County, Tennessee",1965,17,0.87,1948,32.53,"Census Tract 106, Maury County, Tennessee",2267,63,2.78,2204,31.1,"Census Tract 106, Maury County, Tennessee",2305,110,4.77,2195,32.55
1264,47085130400,"Census Tract 1304, Humphreys County, Tennessee",987,48,4.86,939,34.03,"Census Tract 1304, Humphreys County, Tennessee",959,8,0.83,951,32.56,"Census Tract 1304, Humphreys County, Tennessee",834,39,4.68,795,36.62
1265,47119010100,"Census Tract 101, Maury County, Tennessee",1569,73,4.65,1496,41.71,"Census Tract 101, Maury County, Tennessee",1529,67,4.38,1462,38.21,"Census Tract 101, Maury County, Tennessee",1583,92,5.81,1491,39.08
1266,47067960500,"Census Tract 9605, Hancock County, Tennessee",893,59,6.61,834,49.34,"Census Tract 9605, Hancock County, Tennessee",868,48,5.53,820,54.28,"Census Tract 9605, Hancock County, Tennessee",804,74,9.2,730,41.3
1267,47067960600,"Census Tract 9606, Hancock County, Tennessee",1232,31,2.52,1201,35.11,"Census Tract 9606, Hancock County, Tennessee",1297,31,2.39,1266,34.84,"Census Tract 9606, Hancock County, Tennessee",1354,26,1.92,1328,32.84
1268,47085130200,"Census Tract 1302, Humphreys County, Tennessee",706,10,1.42,696,27.37,"Census Tract 1302, Humphreys County, Tennessee",753,0,0.0,753,32.5,"Census Tract 1302, Humphreys County, Tennessee",642,5,0.78,637,38.71
1269,47085130500,"Census Tract 1305, Humphreys County, Tennessee",1038,33,3.18,1005,30.26,"Census Tract 1305, Humphreys County, Tennessee",1185,30,2.53,1155,34.28,"Census Tract 1305, Humphreys County, Tennessee",1220,34,2.79,1186,33.01
1270,47085130300,"Census Tract 1303, Humphreys County, Tennessee",1979,136,6.87,1843,28.83,"Census Tract 1303, Humphreys County, Tennessee",1925,37,1.92,1888,30.47,"Census Tract 1303, Humphreys County, Tennessee",2145,110,5.13,2035,39.05
1271,47085130100,"Census Tract 1301, Humphreys County, Tennessee",2218,34,1.53,2184,37.48,"Census Tract 1301, Humphreys County, Tennessee",2278,50,2.19,2228,34.86,"Census Tract 1301, Humphreys County, Tennessee",2494,17,0.68,2477,46.36
1272,47141000600,"Census Tract 6, Putnam County, Tennessee",1501,60,4.0,1441,19.02,"Census Tract 6, Putnam County, Tennessee",1486,59,3.97,1427,18.69,"Census Tract 6, Putnam County, Tennessee",1696,68,4.01,1628,20.77
1273,47141000301,"Census Tract 3.01, Putnam County, Tennessee",1311,33,2.52,1278,32.5,"Census Tract 3.01, Putnam County, Tennessee",1218,27,2.22,1191,30.98,"Census Tract 3.01, Putnam County, Tennessee",1301,22,1.69,1279,26.63
1274,47141001100,"Census Tract 11, Putnam County, Tennessee",2382,54,2.27,2328,33.56,"Census Tract 11, Putnam County, Tennessee",2738,84,3.07,2654,32.26,"Census Tract 11, Putnam County, Tennessee",2849,151,5.3,2698,32.58
1275,47141000200,"Census Tract 2, Putnam County, Tennessee",3993,136,3.41,3857,24.95,"Census Tract 2, Putnam County, Tennessee",4198,155,3.69,4043,25.52,"Census Tract 2, Putnam County, Tennessee",4702,351,7.46,4351,28.31
1276,47141000800,"Census Tract 8, Putnam County, Tennessee",1385,0,0.0,1385,27.14,"Census Tract 8, Putnam County, Tennessee",1527,1,0.07,1526,25.5,"Census Tract 8, Putnam County, Tennessee",1680,21,1.25,1659,23.16
1277,47141000900,"Census Tract 9, Putnam County, Tennessee",2676,22,0.82,2654,31.16,"Census Tract 9, Putnam County, Tennessee",2566,45,1.75,2521,37.01,"Census Tract 9, Putnam County, Tennessee",2844,150,5.27,2694,35.29
1278,47141000700,"Census Tract 7, Putnam County, Tennessee",1309,9,0.69,1300,20.98,"Census Tract 7, Putnam County, Tennessee",1545,38,2.46,1507,23.53,"Census Tract 7, Putnam County, Tennessee",1576,27,1.71,1549,24.41
1279,47141000100,"Census Tract 1, Putnam County, Tennessee",1752,33,1.88,1719,30.09,"Census Tract 1, Putnam County, Tennessee",1816,34,1.87,1782,33.2,"Census Tract 1, Putnam County, Tennessee",2232,76,3.41,2156,34.14
1280,47141001300,"Census Tract 13, Putnam County, Tennessee",1023,46,4.5,977,28.78,"Census Tract 13, Putnam County, Tennessee",975,28,2.87,947,27.31,"Census Tract 13, Putnam County, Tennessee",1027,11,1.07,1016,29.23
1281,47141001000,"Census Tract 10, Putnam County, Tennessee",1498,43,2.87,1455,44.81,"Census Tract 10, Putnam County, Tennessee",1668,21,1.26,1647,39.35,"Census Tract 10, Putnam County, Tennessee",1559,44,2.82,1515,34.88
1282,47141001200,"Census Tract 12, Putnam County, Tennessee",3864,104,2.69,3760,27.72,"Census Tract 12, Putnam County, Tennessee",4681,166,3.55,4515,27.69,"Census Tract 12, Putnam County, Tennessee",4635,136,2.93,4499,28.62
1283,47141000500,"Census Tract 5, Putnam County, Tennessee",895,20,2.23,875,22.48,"Census Tract 5, Putnam County, Tennessee",866,10,1.15,856,21.76,"Census Tract 5, Putnam County, Tennessee",1189,46,3.87,1143,20.89
1284,47141000400,"Census Tract 4, Putnam County, Tennessee",1754,44,2.51,1710,21.93,"Census Tract 4, Putnam County, Tennessee",2079,83,3.99,1996,22.06,"Census Tract 4, Putnam County, Tennessee",2175,145,6.67,2030,22.77
1285,47157021613,"Census Tract 216.13, Shelby County, Tennessee",2381,167,7.01,2214,29.52,"Census Tract 216.13, Shelby County, Tennessee",2290,182,7.95,2108,30.23,"Census Tract 216.13, Shelby County, Tennessee",2380,151,6.34,2229,33.13
1286,47157007300,"Census Tract 73, Shelby County, Tennessee",2093,125,5.97,1968,19.89,"Census Tract 73, Shelby County, Tennessee",1939,141,7.27,1798,20.4,"Census Tract 73, Shelby County, Tennessee",1748,143,8.18,1605,22.54
1287,47157021320,"Census Tract 213.20, Shelby County, Tennessee",3037,98,3.23,2939,21.93,"Census Tract 213.20, Shelby County, Tennessee",2958,152,5.14,2806,22.51,"Census Tract 213.20, Shelby County, Tennessee",3058,74,2.42,2984,24.35
1288,47157020222,"Census Tract 202.22, Shelby County, Tennessee",1327,7,0.53,1320,37.52,"Census Tract 202.22, Shelby County, Tennessee",1392,16,1.15,1376,35.27,"Census Tract 202.22, Shelby County, Tennessee",1356,0,0.0,1356,36.6
1289,47157022410,"Census Tract 224.10, Shelby County, Tennessee",2392,0,0.0,2392,30.45,"Census Tract 224.10, Shelby County, Tennessee",2303,63,2.74,2240,30.11,"Census Tract 224.10, Shelby County, Tennessee",2134,44,2.06,2090,35.56
1290,47157005300,"Census Tract 53, Shelby County, Tennessee",1029,8,0.78,1021,30.45,"Census Tract 53, Shelby County, Tennessee",954,0,0.0,954,28.48,"Census Tract 53, Shelby County, Tennessee",1126,0,0.0,1126,28.8
1291,47157008500,"Census Tract 85, Shelby County, Tennessee",1963,89,4.53,1874,22.2,"Census Tract 85, Shelby County, Tennessee",1999,129,6.45,1870,23.54,"Census Tract 85, Shelby County, Tennessee",1890,126,6.67,1764,23.32
1292,47157020810,"Census Tract 208.10, Shelby County, Tennessee",1568,66,4.21,1502,33.57,"Census Tract 208.10, Shelby County, Tennessee",1442,99,6.87,1343,35.29,"Census Tract 208.10, Shelby County, Tennessee",1397,52,3.72,1345,36.17
1293,47157021520,"Census Tract 215.20, Shelby County, Tennessee",5469,418,7.64,5051,28.32,"Census Tract 215.20, Shelby County, Tennessee",6909,455,6.59,6454,28.71,"Census Tract 215.20, Shelby County, Tennessee",7299,337,4.62,6962,28.81
1294,47157005700,"Census Tract 57, Shelby County, Tennessee",731,0,0.0,731,23.44,"Census Tract 57, Shelby County, Tennessee",783,28,3.58,755,23.22,"Census Tract 57, Shelby County, Tennessee",843,32,3.8,811,29.02
1295,47157020300,"Census Tract 203, Shelby County, Tennessee",2386,55,2.31,2331,30.47,"Census Tract 203, Shelby County, Tennessee",2568,65,2.53,2503,30.79,"Census Tract 203, Shelby County, Tennessee",1928,141,7.31,1787,32.26
1296,47157020820,"Census Tract 208.20, Shelby County, Tennessee",4012,210,5.23,3802,32.76,"Census Tract 208.20, Shelby County, Tennessee",4109,177,4.31,3932,31.18,"Census Tract 208.20, Shelby County, Tennessee",4349,167,3.84,4182,32.47
1297,47157021135,"Census Tract 211.35, Shelby County, Tennessee",3352,22,0.66,3330,34.28,"Census Tract 211.35, Shelby County, Tennessee",3355,15,0.45,3340,31.71,"Census Tract 211.35, Shelby County, Tennessee",3517,27,0.77,3490,28.99
1298,47157009200,"Census Tract 92, Shelby County, Tennessee",3890,111,2.85,3779,22.37,"Census Tract 92, Shelby County, Tennessee",4042,198,4.9,3844,22.34,"Census Tract 92, Shelby County, Tennessee",3981,204,5.12,3777,23.15
1299,47157021138,"Census Tract 211.38, Shelby County, Tennessee",1778,88,4.95,1690,29.91,"Census Tract 211.38, Shelby County, Tennessee",2048,135,6.59,1913,29.57,"Census Tract 211.38, Shelby County, Tennessee",2109,195,9.25,1914,29.74
1300,47157003300,"Census Tract 33, Shelby County, Tennessee",1401,46,3.28,1355,23.4,"Census Tract 33, Shelby County, Tennessee",1527,132,8.64,1395,25.03,"Census Tract 33, Shelby County, Tennessee",1393,145,10.41,1248,24.52
1301,47157000600,"Census Tract 6, Shelby County, Tennessee",468,0,0.0,468,26.85,"Census Tract 6, Shelby County, Tennessee",466,28,6.01,438,32.47,"Census Tract 6, Shelby County, Tennessee",523,31,5.93,492,32.76
1302,47157021331,"Census Tract 213.31, Shelby County, Tennessee",1607,143,8.9,1464,23.47,"Census Tract 213.31, Shelby County, Tennessee",1589,105,6.61,1484,24.92,"Census Tract 213.31, Shelby County, Tennessee",1683,108,6.42,1575,25.88
1303,47157021352,"Census Tract 213.52, Shelby County, Tennessee",3233,237,7.33,2996,24.77,"Census Tract 213.52, Shelby County, Tennessee",3256,312,9.58,2944,27.33,"Census Tract 213.52, Shelby County, Tennessee",3091,318,10.29,2773,26.76
1304,47069950300,"Census Tract 9503, Hardeman County, Tennessee",1142,67,5.87,1075,20.7,"Census Tract 9503, Hardeman County, Tennessee",1150,96,8.35,1054,26.28,"Census Tract 9503, Hardeman County, Tennessee",1077,7,0.65,1070,34.79
1305,47157021410,"Census Tract 214.10, Shelby County, Tennessee",1318,108,8.19,1210,23.85,"Census Tract 214.10, Shelby County, Tennessee",1385,91,6.57,1294,24.72,"Census Tract 214.10, Shelby County, Tennessee",1474,104,7.06,1370,25.56
1306,47157022130,"Census Tract 221.30, Shelby County, Tennessee",2369,0,0.0,2369,25.57,"Census Tract 221.30, Shelby County, Tennessee",2266,0,0.0,2266,32.85,"Census Tract 221.30, Shelby County, Tennessee",2364,0,0.0,2364,27.64
1307,47157020210,"Census Tract 202.10, Shelby County, Tennessee",2803,153,5.46,2650,31.45,"Census Tract 202.10, Shelby County, Tennessee",2578,125,4.85,2453,30.34,"Census Tract 202.10, Shelby County, Tennessee",2501,97,3.88,2404,29.61
1308,47157010120,"Census Tract 101.20, Shelby County, Tennessee",1641,27,1.65,1614,22.88,"Census Tract 101.20, Shelby County, Tennessee",1937,59,3.05,1878,25.54,"Census Tract 101.20, Shelby County, Tennessee",1860,18,0.97,1842,31.14
1309,47157020610,"Census Tract 206.10, Shelby County, Tennessee",2020,15,0.74,2005,23.61,"Census Tract 206.10, Shelby County, Tennessee",2195,15,0.68,2180,24.66,"Census Tract 206.10, Shelby County, Tennessee",2158,26,1.2,2132,25.69
1310,47019070900,"Census Tract 709, Carter County, Tennessee",1796,54,3.01,1742,20.53,"Census Tract 709, Carter County, Tennessee",1756,108,6.15,1648,19.45,"Census Tract 709, Carter County, Tennessee",1675,120,7.16,1555,20.85
1311,47161110200,"Census Tract 1102, Stewart County, Tennessee",2020,87,4.31,1933,39.2,"Census Tract 1102, Stewart County, Tennessee",2342,61,2.6,2281,38.71,"Census Tract 1102, Stewart County, Tennessee",2597,48,1.85,2549,35.96
1312,47161980200,"Census Tract 9802, Stewart County, Tennessee",0,0,,0,0.0,"Census Tract 9802, Stewart County, Tennessee",0,0,,0,0.0,"Census Tract 9802, Stewart County, Tennessee",0,0,,0,0.0
1313,47161980100,"Census Tract 9801, Stewart County, Tennessee",0,0,,0,0.0,"Census Tract 9801, Stewart County, Tennessee",0,0,,0,0.0,"Census Tract 9801, Stewart County, Tennessee",0,0,,0,0.0
1314,47161110600,"Census Tract 1106, Stewart County, Tennessee",986,27,2.74,959,41.98,"Census Tract 1106, Stewart County, Tennessee",958,28,2.92,930,51.21,"Census Tract 1106, Stewart County, Tennessee",919,44,4.79,875,56.4
1315,47097050200,"Census Tract 502, Lauderdale County, Tennessee",1523,8,0.53,1515,22.78,"Census Tract 502, Lauderdale County, Tennessee",1334,0,0.0,1334,25.8,"Census Tract 502, Lauderdale County, Tennessee",1251,0,0.0,1251,29.59
1316,47097050100,"Census Tract 501, Lauderdale County, Tennessee",476,0,0.0,476,33.08,"Census Tract 501, Lauderdale County, Tennessee",408,19,4.66,389,32.42,"Census Tract 501, Lauderdale County, Tennessee",431,14,3.25,417,43.73
1317,47097050300,"Census Tract 503, Lauderdale County, Tennessee",1048,15,1.43,1033,38.48,"Census Tract 503, Lauderdale County, Tennessee",1099,15,1.36,1084,34.92,"Census Tract 503, Lauderdale County, Tennessee",1166,11,0.94,1155,39.98
1318,47097050600,"Census Tract 506, Lauderdale County, Tennessee",759,4,0.53,755,26.26,"Census Tract 506, Lauderdale County, Tennessee",759,17,2.24,742,26.34,"Census Tract 506, Lauderdale County, Tennessee",741,29,3.91,712,30.1
1319,47097050400,"Census Tract 504, Lauderdale County, Tennessee",1179,15,1.27,1164,30.86,"Census Tract 504, Lauderdale County, Tennessee",1287,25,1.94,1262,29.66,"Census Tract 504, Lauderdale County, Tennessee",1253,14,1.12,1239,32.48
1320,47157001600,"Census Tract 16, Shelby County, Tennessee",1491,98,6.57,1393,20.81,"Census Tract 16, Shelby County, Tennessee",1500,120,8.0,1380,19.59,"Census Tract 16, Shelby County, Tennessee",1425,83,5.82,1342,20.54
1321,47091956200,"Census Tract 9562, Johnson County, Tennessee",861,92,10.69,769,42.66,"Census Tract 9562, Johnson County, Tennessee",811,60,7.4,751,44.14,"Census Tract 9562, Johnson County, Tennessee",959,87,9.07,872,35.08
1322,47091956300,"Census Tract 9563, Johnson County, Tennessee",2102,214,10.18,1888,25.27,"Census Tract 9563, Johnson County, Tennessee",1952,132,6.76,1820,22.37,"Census Tract 9563, Johnson County, Tennessee",1648,155,9.41,1493,23.8
1323,47091956000,"Census Tract 9560, Johnson County, Tennessee",248,17,6.85,231,54.52,"Census Tract 9560, Johnson County, Tennessee",272,0,0.0,272,56.52,"Census Tract 9560, Johnson County, Tennessee",383,18,4.7,365,53.16
1324,47091956400,"Census Tract 9564, Johnson County, Tennessee",1634,0,0.0,1634,31.17,"Census Tract 9564, Johnson County, Tennessee",1481,2,0.14,1479,29.35,"Census Tract 9564, Johnson County, Tennessee",1558,33,2.12,1525,27.58
1325,47091956100,"Census Tract 9561, Johnson County, Tennessee",1088,72,6.62,1016,38.1,"Census Tract 9561, Johnson County, Tennessee",1027,65,6.33,962,34.59,"Census Tract 9561, Johnson County, Tennessee",1058,25,2.36,1033,30.58
1326,47157007810,"Census Tract 78.10, Shelby County, Tennessee",619,0,0.0,619,34.48,"Census Tract 78.10, Shelby County, Tennessee",660,0,0.0,660,34.42,"Census Tract 78.10, Shelby County, Tennessee",521,22,4.22,499,24.65
1327,47033961000,"Census Tract 9610, Crockett County, Tennessee",896,63,7.03,833,28.39,"Census Tract 9610, Crockett County, Tennessee",868,52,5.99,816,28.75,"Census Tract 9610, Crockett County, Tennessee",917,52,5.67,865,31.51
1328,47033961400,"Census Tract 9614, Crockett County, Tennessee",1636,95,5.81,1541,27.22,"Census Tract 9614, Crockett County, Tennessee",1797,45,2.5,1752,29.2,"Census Tract 9614, Crockett County, Tennessee",1755,29,1.65,1726,29.03
1329,47033961200,"Census Tract 9612, Crockett County, Tennessee",793,0,0.0,793,32.77,"Census Tract 9612, Crockett County, Tennessee",822,4,0.49,818,33.14,"Census Tract 9612, Crockett County, Tennessee",793,22,2.77,771,35.17
1330,47033961100,"Census Tract 9611, Crockett County, Tennessee",1364,7,0.51,1357,25.13,"Census Tract 9611, Crockett County, Tennessee",1580,0,0.0,1580,24.07,"Census Tract 9611, Crockett County, Tennessee",1525,0,0.0,1525,25.7
1331,47033961300,"Census Tract 9613, Crockett County, Tennessee",946,41,4.33,905,30.0,"Census Tract 9613, Crockett County, Tennessee",882,12,1.36,870,30.14,"Census Tract 9613, Crockett County, Tennessee",994,19,1.91,975,29.81
1332,47157003100,"Census Tract 31, Shelby County, Tennessee",2242,49,2.19,2193,20.85,"Census Tract 31, Shelby County, Tennessee",2157,64,2.97,2093,21.4,"Census Tract 31, Shelby County, Tennessee",2256,118,5.23,2138,22.63
1333,47157003200,"Census Tract 32, Shelby County, Tennessee",1935,95,4.91,1840,20.83,"Census Tract 32, Shelby County, Tennessee",1988,101,5.08,1887,21.58,"Census Tract 32, Shelby County, Tennessee",2135,80,3.75,2055,20.59
1334,47189030309,"Census Tract 303.09, Wilson County, Tennessee",2805,249,8.88,2556,34.92,"Census Tract 303.09, Wilson County, Tennessee",2420,234,9.67,2186,32.94,"Census Tract 303.09, Wilson County, Tennessee",2578,211,8.18,2367,35.63
1335,47141000302,"Census Tract 3.02, Putnam County, Tennessee",3363,122,3.63,3241,27.74,"Census Tract 3.02, Putnam County, Tennessee",3668,82,2.24,3586,25.3,"Census Tract 3.02, Putnam County, Tennessee",3716,32,0.86,3684,26.21
1336,47069950500,"Census Tract 9505, Hardeman County, Tennessee",1629,65,3.99,1564,41.09,"Census Tract 9505, Hardeman County, Tennessee",1480,73,4.93,1407,39.31,"Census Tract 9505, Hardeman County, Tennessee",1675,78,4.66,1597,39.54
1337,47069950600,"Census Tract 9506, Hardeman County, Tennessee",943,41,4.35,902,46.53,"Census Tract 9506, Hardeman County, Tennessee",835,24,2.87,811,46.22,"Census Tract 9506, Hardeman County, Tennessee",774,22,2.84,752,45.41
1338,47069950100,"Census Tract 9501, Hardeman County, Tennessee",1475,111,7.53,1364,39.98,"Census Tract 9501, Hardeman County, Tennessee",1384,78,5.64,1306,40.15,"Census Tract 9501, Hardeman County, Tennessee",1475,71,4.81,1404,37.48
1339,47069950200,"Census Tract 9502, Hardeman County, Tennessee",1253,101,8.06,1152,39.29,"Census Tract 9502, Hardeman County, Tennessee",1091,89,8.16,1002,40.94,"Census Tract 9502, Hardeman County, Tennessee",1053,36,3.42,1017,34.24
1340,47069950400,"Census Tract 9504, Hardeman County, Tennessee",1765,47,2.66,1718,28.45,"Census Tract 9504, Hardeman County, Tennessee",2145,58,2.7,2087,29.02,"Census Tract 9504, Hardeman County, Tennessee",1825,37,2.03,1788,34.95
1341,47045964900,"Census Tract 9649, Dyer County, Tennessee",2542,44,1.73,2498,28.65,"Census Tract 9649, Dyer County, Tennessee",2395,51,2.13,2344,25.41,"Census Tract 9649, Dyer County, Tennessee",2401,57,2.37,2344,23.85
1342,47125101001,"Census Tract 1010.01, Montgomery County, Tennessee",1598,11,0.69,1587,35.78,"Census Tract 1010.01, Montgomery County, Tennessee",1687,0,0.0,1687,41.73,"Census Tract 1010.01, Montgomery County, Tennessee",1904,0,0.0,1904,39.93
1343,47125100300,"Census Tract 1003, Montgomery County, Tennessee",2548,55,2.16,2493,27.18,"Census Tract 1003, Montgomery County, Tennessee",2233,54,2.42,2179,27.26,"Census Tract 1003, Montgomery County, Tennessee",2255,37,1.64,2218,32.84
1344,47009980100,"Census Tract 9801, Blount County, Tennessee",5,0,0.0,5,16.0,"Census Tract 9801, Blount County, Tennessee",3,0,0.0,3,17.33,"Census Tract 9801, Blount County, Tennessee",2,0,0.0,2,19.0
1345,47009011502,"Census Tract 115.02, Blount County, Tennessee",1747,35,2.0,1712,35.72,"Census Tract 115.02, Blount County, Tennessee",1911,46,2.41,1865,33.4,"Census Tract 115.02, Blount County, Tennessee",1813,80,4.41,1733,32.61
1346,47125102001,"Census Tract 1020.01, Montgomery County, Tennessee",2679,71,2.65,2608,24.6,"Census Tract 1020.01, Montgomery County, Tennessee",2965,51,1.72,2914,26.92,"Census Tract 1020.01, Montgomery County, Tennessee",3080,29,0.94,3051,29.73
1347,47125101201,"Census Tract 1012.01, Montgomery County, Tennessee",920,0,0.0,920,27.53,"Census Tract 1012.01, Montgomery County, Tennessee",892,21,2.35,871,34.37,"Census Tract 1012.01, Montgomery County, Tennessee",870,14,1.61,856,34.54
1348,47125101304,"Census Tract 1013.04, Montgomery County, Tennessee",2510,8,0.32,2502,24.99,"Census Tract 1013.04, Montgomery County, Tennessee",2457,49,1.99,2408,23.6,"Census Tract 1013.04, Montgomery County, Tennessee",2761,41,1.48,2720,23.54
1349,47045964000,"Census Tract 9640, Dyer County, Tennessee",2852,29,1.02,2823,29.1,"Census Tract 9640, Dyer County, Tennessee",2827,76,2.69,2751,30.06,"Census Tract 9640, Dyer County, Tennessee",2892,59,2.04,2833,30.69
1350,47113000800,"Census Tract 8, Madison County, Tennessee",215,26,12.09,189,19.32,"Census Tract 8, Madison County, Tennessee",360,4,1.11,356,19.4,"Census Tract 8, Madison County, Tennessee",337,0,0.0,337,18.22
1351,47045964500,"Census Tract 9645, Dyer County, Tennessee",981,14,1.43,967,28.5,"Census Tract 9645, Dyer County, Tennessee",1085,39,3.59,1046,29.85,"Census Tract 9645, Dyer County, Tennessee",1151,41,3.56,1110,27.13
1352,47045964200,"Census Tract 9642, Dyer County, Tennessee",2405,70,2.91,2335,18.06,"Census Tract 9642, Dyer County, Tennessee",2746,179,6.52,2567,18.51,"Census Tract 9642, Dyer County, Tennessee",2566,183,7.13,2383,19.48
1353,47045964800,"Census Tract 9648, Dyer County, Tennessee",1339,37,2.76,1302,27.78,"Census Tract 9648, Dyer County, Tennessee",1670,64,3.83,1606,30.02,"Census Tract 9648, Dyer County, Tennessee",1507,7,0.46,1500,26.86
1354,47045964300,"Census Tract 9643, Dyer County, Tennessee",2181,0,0.0,2181,24.55,"Census Tract 9643, Dyer County, Tennessee",1954,0,0.0,1954,20.74,"Census Tract 9643, Dyer County, Tennessee",2167,0,0.0,2167,21.27
1355,47045964400,"Census Tract 9644, Dyer County, Tennessee",2359,13,0.55,2346,21.74,"Census Tract 9644, Dyer County, Tennessee",2149,11,0.51,2138,26.26,"Census Tract 9644, Dyer County, Tennessee",2140,59,2.76,2081,27.32
1356,47045964600,"Census Tract 9646, Dyer County, Tennessee",1160,0,0.0,1160,29.53,"Census Tract 9646, Dyer County, Tennessee",1142,10,0.88,1132,25.75,"Census Tract 9646, Dyer County, Tennessee",1227,12,0.98,1215,29.0
1357,47113001502,"Census Tract 15.02, Madison County, Tennessee",2710,75,2.77,2635,30.25,"Census Tract 15.02, Madison County, Tennessee",2577,86,3.34,2491,28.2,"Census Tract 15.02, Madison County, Tennessee",2747,120,4.37,2627,27.4
1358,47149040307,"Census Tract 403.07, Rutherford County, Tennessee",1743,77,4.42,1666,32.39,"Census Tract 403.07, Rutherford County, Tennessee",1722,137,7.96,1585,35.64,"Census Tract 403.07, Rutherford County, Tennessee",1544,124,8.03,1420,35.73
1359,47149040102,"Census Tract 401.02, Rutherford County, Tennessee",1835,19,1.04,1816,39.89,"Census Tract 401.02, Rutherford County, Tennessee",1952,24,1.23,1928,40.81,"Census Tract 401.02, Rutherford County, Tennessee",1954,128,6.55,1826,40.86
1360,47149040308,"Census Tract 403.08, Rutherford County, Tennessee",3572,67,1.88,3505,35.3,"Census Tract 403.08, Rutherford County, Tennessee",3617,92,2.54,3525,42.79,"Census Tract 403.08, Rutherford County, Tennessee",3338,148,4.43,3190,38.28
1361,47119011102,"Census Tract 111.02, Maury County, Tennessee",1111,76,6.84,1035,35.41,"Census Tract 111.02, Maury County, Tennessee",1167,60,5.14,1107,33.7,"Census Tract 111.02, Maury County, Tennessee",1565,135,8.63,1430,26.63
1362,47119010801,"Census Tract 108.01, Maury County, Tennessee",1610,92,5.71,1518,35.04,"Census Tract 108.01, Maury County, Tennessee",1768,55,3.11,1713,30.47,"Census Tract 108.01, Maury County, Tennessee",1700,56,3.29,1644,31.75
1363,47157003500,"Census Tract 35, Shelby County, Tennessee",2025,86,4.25,1939,26.65,"Census Tract 35, Shelby County, Tennessee",1989,93,4.68,1896,24.27,"Census Tract 35, Shelby County, Tennessee",1829,110,6.01,1719,24.49
1364,47143975401,"Census Tract 9754.01, Rhea County, Tennessee",2475,31,1.25,2444,20.33,"Census Tract 9754.01, Rhea County, Tennessee",2750,32,1.16,2718,21.75,"Census Tract 9754.01, Rhea County, Tennessee",2608,26,1.0,2582,20.83
1365,47157003600,"Census Tract 36, Shelby County, Tennessee",1044,7,0.67,1037,25.76,"Census Tract 36, Shelby County, Tennessee",1020,6,0.59,1014,27.48,"Census Tract 36, Shelby County, Tennessee",901,7,0.78,894,26.53
1366,47157003700,"Census Tract 37, Shelby County, Tennessee",484,4,0.83,480,21.22,"Census Tract 37, Shelby County, Tennessee",416,6,1.44,410,21.3,"Census Tract 37, Shelby County, Tennessee",441,3,0.68,438,23.75
1367,47163043302,"Census Tract 433.02, Sullivan County, Tennessee",2410,112,4.65,2298,31.88,"Census Tract 433.02, Sullivan County, Tennessee",2514,142,5.65,2372,26.42,"Census Tract 433.02, Sullivan County, Tennessee",2512,86,3.42,2426,29.07
1368,47163043201,"Census Tract 432.01, Sullivan County, Tennessee",2115,119,5.63,1996,25.89,"Census Tract 432.01, Sullivan County, Tennessee",1998,118,5.91,1880,27.84,"Census Tract 432.01, Sullivan County, Tennessee",1897,57,3.0,1840,30.2
1369,47157021141,"Census Tract 211.41, Shelby County, Tennessee",4214,234,5.55,3980,35.4,"Census Tract 211.41, Shelby County, Tennessee",3919,393,10.03,3526,31.29,"Census Tract 211.41, Shelby County, Tennessee",3968,280,7.06,3688,30.19
1370,47157000200,"Census Tract 2, Shelby County, Tennessee",276,0,0.0,276,31.19,"Census Tract 2, Shelby County, Tennessee",228,0,0.0,228,33.36,"Census Tract 2, Shelby County, Tennessee",240,0,0.0,240,31.42
1371,47157980400,"Census Tract 9804, Shelby County, Tennessee",0,0,,0,0.0,"Census Tract 9804, Shelby County, Tennessee",0,0,,0,0.0,"Census Tract 9804, Shelby County, Tennessee",0,0,,0,0.0
1372,47157021140,"Census Tract 211.40, Shelby County, Tennessee",2775,48,1.73,2727,26.64,"Census Tract 211.40, Shelby County, Tennessee",2984,178,5.97,2806,26.9,"Census Tract 211.40, Shelby County, Tennessee",2959,207,7.0,2752,26.64
1373,47157020831,"Census Tract 208.31, Shelby County, Tennessee",1836,55,3.0,1781,31.98,"Census Tract 208.31, Shelby County, Tennessee",1830,48,2.62,1782,32.79,"Census Tract 208.31, Shelby County, Tennessee",1877,55,2.93,1822,31.2
1374,47155080801,"Census Tract 808.01, Sevier County, Tennessee",1279,67,5.24,1212,28.37,"Census Tract 808.01, Sevier County, Tennessee",1203,57,4.74,1146,25.64,"Census Tract 808.01, Sevier County, Tennessee",1149,62,5.4,1087,26.39
1375,47155980100,"Census Tract 9801, Sevier County, Tennessee",0,0,,0,0.0,"Census Tract 9801, Sevier County, Tennessee",0,0,,0,0.0,"Census Tract 9801, Sevier County, Tennessee",0,0,,0,0.0
1376,47113000100,"Census Tract 1, Madison County, Tennessee",1568,110,7.02,1458,19.83,"Census Tract 1, Madison County, Tennessee",1512,149,9.85,1363,20.04,"Census Tract 1, Madison County, Tennessee",1551,144,9.28,1407,18.08
1377,47113000200,"Census Tract 2, Madison County, Tennessee",2548,102,4.0,2446,18.19,"Census Tract 2, Madison County, Tennessee",2573,36,1.4,2537,16.44,"Census Tract 2, Madison County, Tennessee",3105,12,0.39,3093,18.83
1378,47113000400,"Census Tract 4, Madison County, Tennessee",1466,32,2.18,1434,19.64,"Census Tract 4, Madison County, Tennessee",1647,24,1.46,1623,22.96,"Census Tract 4, Madison County, Tennessee",1424,8,0.56,1416,23.53
1379,47113001900,"Census Tract 19, Madison County, Tennessee",1574,53,3.37,1521,32.07,"Census Tract 19, Madison County, Tennessee",1490,8,0.54,1482,30.42,"Census Tract 19, Madison County, Tennessee",1644,19,1.16,1625,29.8
1380,47113001605,"Census Tract 16.05, Madison County, Tennessee",1139,55,4.83,1084,20.15,"Census Tract 16.05, Madison County, Tennessee",1167,91,7.8,1076,18.67,"Census Tract 16.05, Madison County, Tennessee",1168,71,6.08,1097,19.44
1381,47113001607,"Census Tract 16.07, Madison County, Tennessee",2999,236,7.87,2763,24.03,"Census Tract 16.07, Madison County, Tennessee",2882,183,6.35,2699,23.14,"Census Tract 16.07, Madison County, Tennessee",2795,156,5.58,2639,27.8
1382,47113001609,"Census Tract 16.09, Madison County, Tennessee",729,60,8.23,669,28.07,"Census Tract 16.09, Madison County, Tennessee",751,39,5.19,712,23.7,"Census Tract 16.09, Madison County, Tennessee",750,35,4.67,715,23.82
1383,47113001610,"Census Tract 16.10, Madison County, Tennessee",2693,148,5.5,2545,26.86,"Census Tract 16.10, Madison County, Tennessee",2991,164,5.48,2827,25.67,"Census Tract 16.10, Madison County, Tennessee",3008,159,5.29,2849,24.68
1384,47113001300,"Census Tract 13, Madison County, Tennessee",2546,30,1.18,2516,22.49,"Census Tract 13, Madison County, Tennessee",2320,9,0.39,2311,25.26,"Census Tract 13, Madison County, Tennessee",2235,93,4.16,2142,26.38
1385,47113001100,"Census Tract 11, Madison County, Tennessee",289,0,0.0,289,23.0,"Census Tract 11, Madison County, Tennessee",236,0,0.0,236,27.52,"Census Tract 11, Madison County, Tennessee",325,6,1.85,319,17.79
1386,47113001700,"Census Tract 17, Madison County, Tennessee",670,21,3.13,649,26.65,"Census Tract 17, Madison County, Tennessee",665,17,2.56,648,25.88,"Census Tract 17, Madison County, Tennessee",615,19,3.09,596,22.26
1387,47113001501,"Census Tract 15.01, Madison County, Tennessee",2546,138,5.42,2408,23.84,"Census Tract 15.01, Madison County, Tennessee",2639,33,1.25,2606,22.49,"Census Tract 15.01, Madison County, Tennessee",2521,56,2.22,2465,26.47
1388,47113001608,"Census Tract 16.08, Madison County, Tennessee",1081,24,2.22,1057,27.88,"Census Tract 16.08, Madison County, Tennessee",1046,23,2.2,1023,26.11,"Census Tract 16.08, Madison County, Tennessee",1182,10,0.85,1172,26.53
1389,47113001402,"Census Tract 14.02, Madison County, Tennessee",1045,20,1.91,1025,24.05,"Census Tract 14.02, Madison County, Tennessee",1080,38,3.52,1042,24.96,"Census Tract 14.02, Madison County, Tennessee",1052,33,3.14,1019,26.16
1390,47151975400,"Census Tract 9754, Scott County, Tennessee",1043,12,1.15,1031,40.55,"Census Tract 9754, Scott County, Tennessee",1076,18,1.67,1058,39.76,"Census Tract 9754, Scott County, Tennessee",1144,17,1.49,1127,39.45
1391,47151975100,"Census Tract 9751, Scott County, Tennessee",2503,28,1.12,2475,31.13,"Census Tract 9751, Scott County, Tennessee",2646,11,0.42,2635,29.31,"Census Tract 9751, Scott County, Tennessee",2394,16,0.67,2378,31.88
1392,47151975000,"Census Tract 9750, Scott County, Tennessee",1210,15,1.24,1195,36.18,"Census Tract 9750, Scott County, Tennessee",1404,46,3.28,1358,37.65,"Census Tract 9750, Scott County, Tennessee",1456,96,6.59,1360,36.29
1393,47151975300,"Census Tract 9753, Scott County, Tennessee",658,10,1.52,648,45.62,"Census Tract 9753, Scott County, Tennessee",728,3,0.41,725,43.76,"Census Tract 9753, Scott County, Tennessee",863,2,0.23,861,33.96
1394,47151975200,"Census Tract 9752, Scott County, Tennessee",2181,174,7.98,2007,30.54,"Census Tract 9752, Scott County, Tennessee",2262,152,6.72,2110,28.54,"Census Tract 9752, Scott County, Tennessee",2040,141,6.91,1899,31.74
1395,47181950200,"Census Tract 9502, Wayne County, Tennessee",2122,10,0.47,2112,24.57,"Census Tract 9502, Wayne County, Tennessee",2121,12,0.57,2109,25.49,"Census Tract 9502, Wayne County, Tennessee",1931,21,1.09,1910,27.55
1396,47113000500,"Census Tract 5, Madison County, Tennessee",1247,18,1.44,1229,24.03,"Census Tract 5, Madison County, Tennessee",1094,14,1.28,1080,20.33,"Census Tract 5, Madison County, Tennessee",1257,34,2.7,1223,18.21
1397,47113000600,"Census Tract 6, Madison County, Tennessee",898,19,2.12,879,26.52,"Census Tract 6, Madison County, Tennessee",889,33,3.71,856,26.28,"Census Tract 6, Madison County, Tennessee",914,28,3.06,886,24.53
1398,47157011100,"Census Tract 111, Shelby County, Tennessee",609,14,2.3,595,28.17,"Census Tract 111, Shelby County, Tennessee",450,3,0.67,447,26.87,"Census Tract 111, Shelby County, Tennessee",410,0,0.0,410,26.62
1399,47181950100,"Census Tract 9501, Wayne County, Tennessee",837,69,8.24,768,37.66,"Census Tract 9501, Wayne County, Tennessee",1060,56,5.28,1004,40.07,"Census Tract 9501, Wayne County, Tennessee",1261,50,3.97,1211,41.01
1400,47181950400,"Census Tract 9504, Wayne County, Tennessee",1071,0,0.0,1071,40.98,"Census Tract 9504, Wayne County, Tennessee",1022,24,2.35,998,49.37,"Census Tract 9504, Wayne County, Tennessee",1097,53,4.83,1044,45.53
1401,47037015630,"Census Tract 156.30, Davidson County, Tennessee",2400,106,4.42,2294,36.99,"Census Tract 156.30, Davidson County, Tennessee",2623,74,2.82,2549,36.37,"Census Tract 156.30, Davidson County, Tennessee",2959,71,2.4,2888,36.21
1402,47037018904,"Census Tract 189.04, Davidson County, Tennessee",1704,63,3.7,1641,31.52,"Census Tract 189.04, Davidson County, Tennessee",2087,73,3.5,2014,32.63,"Census Tract 189.04, Davidson County, Tennessee",2239,72,3.22,2167,36.01
1403,47187050701,"Census Tract 507.01, Williamson County, Tennessee",2082,159,7.64,1923,32.64,"Census Tract 507.01, Williamson County, Tennessee",2192,144,6.57,2048,31.56,"Census Tract 507.01, Williamson County, Tennessee",2215,165,7.45,2050,33.55
1404,47021070104,"Census Tract 701.04, Cheatham County, Tennessee",2555,139,5.44,2416,38.61,"Census Tract 701.04, Cheatham County, Tennessee",2379,87,3.66,2292,36.4,"Census Tract 701.04, Cheatham County, Tennessee",2634,62,2.35,2572,35.94
1405,47021070202,"Census Tract 702.02, Cheatham County, Tennessee",1981,43,2.17,1938,41.04,"Census Tract 702.02, Cheatham County, Tennessee",2439,110,4.51,2329,40.33,"Census Tract 702.02, Cheatham County, Tennessee",2616,184,7.03,2432,43.16
1406,47181950300,"Census Tract 9503, Wayne County, Tennessee",1561,21,1.35,1540,34.86,"Census Tract 9503, Wayne County, Tennessee",1562,37,2.37,1525,35.3,"Census Tract 9503, Wayne County, Tennessee",1357,34,2.51,1323,40.32
1407,47113001000,"Census Tract 10, Madison County, Tennessee",684,26,3.8,658,23.42,"Census Tract 10, Madison County, Tennessee",606,0,0.0,606,21.98,"Census Tract 10, Madison County, Tennessee",581,0,0.0,581,19.86
1408,47113001603,"Census Tract 16.03, Madison County, Tennessee",1194,36,3.02,1158,22.79,"Census Tract 16.03, Madison County, Tennessee",1202,50,4.16,1152,21.0,"Census Tract 16.03, Madison County, Tennessee",1289,25,1.94,1264,21.19
1409,47113000700,"Census Tract 7, Madison County, Tennessee",897,37,4.12,860,22.08,"Census Tract 7, Madison County, Tennessee",858,37,4.31,821,25.9,"Census Tract 7, Madison County, Tennessee",843,63,7.47,780,26.31
1410,47157003800,"Census Tract 38, Shelby County, Tennessee",529,18,3.4,511,20.1,"Census Tract 38, Shelby County, Tennessee",335,15,4.48,320,20.0,"Census Tract 38, Shelby County, Tennessee",305,20,6.56,285,20.81
1411,47157003900,"Census Tract 39, Shelby County, Tennessee",447,0,0.0,447,22.19,"Census Tract 39, Shelby County, Tennessee",618,14,2.27,604,21.95,"Census Tract 39, Shelby County, Tennessee",722,0,0.0,722,22.08
1412,47037018905,"Census Tract 189.05, Davidson County, Tennessee",1782,44,2.47,1738,27.27,"Census Tract 189.05, Davidson County, Tennessee",1896,22,1.16,1874,28.41,"Census Tract 189.05, Davidson County, Tennessee",1843,14,0.76,1829,30.58
1413,47037013601,"Census Tract 136.01, Davidson County, Tennessee",1448,87,6.01,1361,21.88,"Census Tract 136.01, Davidson County, Tennessee",1327,0,0.0,1327,26.51,"Census Tract 136.01, Davidson County, Tennessee",1479,37,2.5,1442,29.29
1414,47037018301,"Census Tract 183.01, Davidson County, Tennessee",4189,249,5.94,3940,31.31,"Census Tract 183.01, Davidson County, Tennessee",4155,277,6.67,3878,31.39,"Census Tract 183.01, Davidson County, Tennessee",4850,334,6.89,4516,28.55
1415,47037018302,"Census Tract 183.02, Davidson County, Tennessee",1379,51,3.7,1328,31.82,"Census Tract 183.02, Davidson County, Tennessee",1383,68,4.92,1315,34.14,"Census Tract 183.02, Davidson County, Tennessee",1532,109,7.11,1423,36.81
1416,47037015631,"Census Tract 156.31, Davidson County, Tennessee",5392,140,2.6,5252,35.26,"Census Tract 156.31, Davidson County, Tennessee",5857,271,4.63,5586,40.23,"Census Tract 156.31, Davidson County, Tennessee",6327,299,4.73,6028,42.31
1417,47075930500,"Census Tract 9305, Haywood County, Tennessee",977,42,4.3,935,39.8,"Census Tract 9305, Haywood County, Tennessee",1193,20,1.68,1173,33.49,"Census Tract 9305, Haywood County, Tennessee",1107,0,0.0,1107,35.61
1418,47157021311,"Census Tract 213.11, Shelby County, Tennessee",1889,123,6.51,1766,20.21,"Census Tract 213.11, Shelby County, Tennessee",2117,256,12.09,1861,22.09,"Census Tract 213.11, Shelby County, Tennessee",2231,199,8.92,2032,24.58
1419,47157022122,"Census Tract 221.22, Shelby County, Tennessee",1718,5,0.29,1713,23.94,"Census Tract 221.22, Shelby County, Tennessee",1833,11,0.6,1822,24.11,"Census Tract 221.22, Shelby County, Tennessee",1707,13,0.76,1694,25.45
1420,47157022600,"Census Tract 226, Shelby County, Tennessee",2039,51,2.5,1988,26.73,"Census Tract 226, Shelby County, Tennessee",1995,23,1.15,1972,23.81,"Census Tract 226, Shelby County, Tennessee",1785,134,7.51,1651,24.54
1421,47157020101,"Census Tract 201.01, Shelby County, Tennessee",1480,63,4.26,1417,32.93,"Census Tract 201.01, Shelby County, Tennessee",1290,47,3.64,1243,30.53,"Census Tract 201.01, Shelby County, Tennessee",1268,24,1.89,1244,30.8
1422,47157020102,"Census Tract 201.02, Shelby County, Tennessee",1360,52,3.82,1308,33.25,"Census Tract 201.02, Shelby County, Tennessee",1463,111,7.59,1352,36.64,"Census Tract 201.02, Shelby County, Tennessee",1367,92,6.73,1275,37.1
1423,47075930100,"Census Tract 9301, Haywood County, Tennessee",984,59,6.0,925,30.78,"Census Tract 9301, Haywood County, Tennessee",1033,25,2.42,1008,30.68,"Census Tract 9301, Haywood County, Tennessee",1038,33,3.18,1005,28.65
1424,47075930200,"Census Tract 9302, Haywood County, Tennessee",590,24,4.07,566,32.01,"Census Tract 9302, Haywood County, Tennessee",597,10,1.68,587,28.7,"Census Tract 9302, Haywood County, Tennessee",598,0,0.0,598,31.69
1425,47075930400,"Census Tract 9304, Haywood County, Tennessee",1704,19,1.12,1685,26.45,"Census Tract 9304, Haywood County, Tennessee",1733,9,0.52,1724,24.33,"Census Tract 9304, Haywood County, Tennessee",1561,5,0.32,1556,29.89
1426,47025970400,"Census Tract 9704, Claiborne County, Tennessee",186,0,0.0,186,39.38,"Census Tract 9704, Claiborne County, Tennessee",180,0,0.0,180,30.92,"Census Tract 9704, Claiborne County, Tennessee",233,0,0.0,233,31.98
1427,47113000300,"Census Tract 3, Madison County, Tennessee",1804,8,0.44,1796,17.46,"Census Tract 3, Madison County, Tennessee",1730,41,2.37,1689,18.1,"Census Tract 3, Madison County, Tennessee",1891,76,4.02,1815,18.84
1428,47025970300,"Census Tract 9703, Claiborne County, Tennessee",1328,41,3.09,1287,30.05,"Census Tract 9703, Claiborne County, Tennessee",1283,36,2.81,1247,29.5,"Census Tract 9703, Claiborne County, Tennessee",1468,85,5.79,1383,33.43
1429,47025970500,"Census Tract 9705, Claiborne County, Tennessee",967,69,7.14,898,38.24,"Census Tract 9705, Claiborne County, Tennessee",945,48,5.08,897,38.22,"Census Tract 9705, Claiborne County, Tennessee",925,62,6.7,863,41.12
1430,47025970700,"Census Tract 9707, Claiborne County, Tennessee",1929,31,1.61,1898,26.6,"Census Tract 9707, Claiborne County, Tennessee",1940,53,2.73,1887,26.15,"Census Tract 9707, Claiborne County, Tennessee",2110,50,2.37,2060,24.99
1431,47025970200,"Census Tract 9702, Claiborne County, Tennessee",1082,12,1.11,1070,24.01,"Census Tract 9702, Claiborne County, Tennessee",1114,7,0.63,1107,26.2,"Census Tract 9702, Claiborne County, Tennessee",1168,3,0.26,1165,24.29
1432,47025970900,"Census Tract 9709, Claiborne County, Tennessee",1665,76,4.56,1589,29.17,"Census Tract 9709, Claiborne County, Tennessee",1595,24,1.5,1571,27.12,"Census Tract 9709, Claiborne County, Tennessee",1543,9,0.58,1534,32.82
1433,47025970600,"Census Tract 9706, Claiborne County, Tennessee",2063,69,3.34,1994,31.33,"Census Tract 9706, Claiborne County, Tennessee",1988,48,2.41,1940,31.45,"Census Tract 9706, Claiborne County, Tennessee",2086,28,1.34,2058,29.14
1434,47025970100,"Census Tract 9701, Claiborne County, Tennessee",1138,0,0.0,1138,31.04,"Census Tract 9701, Claiborne County, Tennessee",1050,46,4.38,1004,31.98,"Census Tract 9701, Claiborne County, Tennessee",943,63,6.68,880,33.63
1435,47025970800,"Census Tract 9708, Claiborne County, Tennessee",1295,168,12.97,1127,29.45,"Census Tract 9708, Claiborne County, Tennessee",1334,168,12.59,1166,31.98,"Census Tract 9708, Claiborne County, Tennessee",1277,135,10.57,1142,32.55
1436,47113001800,"Census Tract 18, Madison County, Tennessee",1490,106,7.11,1384,26.76,"Census Tract 18, Madison County, Tennessee",1464,13,0.89,1451,26.57,"Census Tract 18, Madison County, Tennessee",1523,26,1.71,1497,27.33
1437,47113001604,"Census Tract 16.04, Madison County, Tennessee",1359,50,3.68,1309,19.48,"Census Tract 16.04, Madison County, Tennessee",1517,10,0.66,1507,19.65,"Census Tract 16.04, Madison County, Tennessee",1484,0,0.0,1484,17.39
1438,47113001401,"Census Tract 14.01, Madison County, Tennessee",746,12,1.61,734,19.82,"Census Tract 14.01, Madison County, Tennessee",692,21,3.03,671,19.78,"Census Tract 14.01, Madison County, Tennessee",1061,19,1.79,1042,18.89
1439,47113001606,"Census Tract 16.06, Madison County, Tennessee",5501,205,3.73,5296,20.24,"Census Tract 16.06, Madison County, Tennessee",5603,122,2.18,5481,21.29,"Census Tract 16.06, Madison County, Tennessee",5349,49,0.92,5300,21.93
1440,47167040303,"Census Tract 403.03, Tipton County, Tennessee",2878,58,2.02,2820,39.96,"Census Tract 403.03, Tipton County, Tennessee",3268,93,2.85,3175,41.97,"Census Tract 403.03, Tipton County, Tennessee",3212,91,2.83,3121,38.8
1441,47157009902,"Census Tract 99.02, Shelby County, Tennessee",1011,75,7.42,936,34.44,"Census Tract 99.02, Shelby County, Tennessee",933,46,4.93,887,28.96,"Census Tract 99.02, Shelby County, Tennessee",795,22,2.77,773,22.43
1442,47157020633,"Census Tract 206.33, Shelby County, Tennessee",1712,65,3.8,1647,27.18,"Census Tract 206.33, Shelby County, Tennessee",1527,44,2.88,1483,28.49,"Census Tract 206.33, Shelby County, Tennessee",1285,49,3.81,1236,28.23
1443,47157020634,"Census Tract 206.34, Shelby County, Tennessee",1522,14,0.92,1508,27.52,"Census Tract 206.34, Shelby County, Tennessee",1426,86,6.03,1340,26.69,"Census Tract 206.34, Shelby County, Tennessee",1710,71,4.15,1639,27.66
1444,47157021125,"Census Tract 211.25, Shelby County, Tennessee",2441,128,5.24,2313,25.76,"Census Tract 211.25, Shelby County, Tennessee",2337,79,3.38,2258,26.18,"Census Tract 211.25, Shelby County, Tennessee",2312,19,0.82,2293,27.07
1445,47157021124,"Census Tract 211.24, Shelby County, Tennessee",4388,53,1.21,4335,24.6,"Census Tract 211.24, Shelby County, Tennessee",4491,37,0.82,4454,26.07,"Census Tract 211.24, Shelby County, Tennessee",4348,58,1.33,4290,28.29
1446,47157021726,"Census Tract 217.26, Shelby County, Tennessee",1679,0,0.0,1679,21.36,"Census Tract 217.26, Shelby County, Tennessee",1520,0,0.0,1520,22.03,"Census Tract 217.26, Shelby County, Tennessee",1714,0,0.0,1714,22.82
1447,47157021725,"Census Tract 217.25, Shelby County, Tennessee",3028,54,1.78,2974,25.13,"Census Tract 217.25, Shelby County, Tennessee",2887,48,1.66,2839,24.3,"Census Tract 217.25, Shelby County, Tennessee",2875,65,2.26,2810,25.37
1448,47157021746,"Census Tract 217.46, Shelby County, Tennessee",2187,0,0.0,2187,29.47,"Census Tract 217.46, Shelby County, Tennessee",2611,0,0.0,2611,28.91,"Census Tract 217.46, Shelby County, Tennessee",2472,18,0.73,2454,28.55
1449,47157021747,"Census Tract 217.47, Shelby County, Tennessee",1620,13,0.8,1607,28.94,"Census Tract 217.47, Shelby County, Tennessee",1627,60,3.69,1567,27.07,"Census Tract 217.47, Shelby County, Tennessee",1845,60,3.25,1785,23.79
1450,47157022220,"Census Tract 222.20, Shelby County, Tennessee",1352,21,1.55,1331,29.71,"Census Tract 222.20, Shelby County, Tennessee",1254,0,0.0,1254,29.76,"Census Tract 222.20, Shelby County, Tennessee",1200,17,1.42,1183,30.07
1451,47157022023,"Census Tract 220.23, Shelby County, Tennessee",857,0,0.0,857,31.65,"Census Tract 220.23, Shelby County, Tennessee",678,0,0.0,678,29.77,"Census Tract 220.23, Shelby County, Tennessee",602,7,1.16,595,27.42
1452,47157022024,"Census Tract 220.24, Shelby County, Tennessee",1505,10,0.66,1495,24.67,"Census Tract 220.24, Shelby County, Tennessee",1535,0,0.0,1535,24.81,"Census Tract 220.24, Shelby County, Tennessee",1396,0,0.0,1396,22.18
1453,47157020524,"Census Tract 205.24, Shelby County, Tennessee",2041,71,3.48,1970,27.72,"Census Tract 205.24, Shelby County, Tennessee",2051,58,2.83,1993,27.87,"Census Tract 205.24, Shelby County, Tennessee",2373,70,2.95,2303,29.3
1454,47157020523,"Census Tract 205.23, Shelby County, Tennessee",1281,0,0.0,1281,27.82,"Census Tract 205.23, Shelby County, Tennessee",1140,0,0.0,1140,31.23,"Census Tract 205.23, Shelby County, Tennessee",1138,37,3.25,1101,31.74
1455,47157021126,"Census Tract 211.26, Shelby County, Tennessee",2572,83,3.23,2489,23.64,"Census Tract 211.26, Shelby County, Tennessee",2544,36,1.42,2508,25.53,"Census Tract 211.26, Shelby County, Tennessee",2631,58,2.2,2573,26.47
1456,47157022121,"Census Tract 221.21, Shelby County, Tennessee",1839,35,1.9,1804,24.65,"Census Tract 221.21, Shelby County, Tennessee",1796,47,2.62,1749,23.79,"Census Tract 221.21, Shelby County, Tennessee",1978,63,3.19,1915,26.0
1457,47157021312,"Census Tract 213.12, Shelby County, Tennessee",1374,48,3.49,1326,22.13,"Census Tract 213.12, Shelby County, Tennessee",1453,59,4.06,1394,20.56,"Census Tract 213.12, Shelby County, Tennessee",1308,43,3.29,1265,19.2
1458,47171080200,"Census Tract 802, Unicoi County, Tennessee",2014,67,3.33,1947,22.95,"Census Tract 802, Unicoi County, Tennessee",2171,140,6.45,2031,20.09,"Census Tract 802, Unicoi County, Tennessee",2245,169,7.53,2076,16.93
1459,47171080300,"Census Tract 803, Unicoi County, Tennessee",2125,80,3.76,2045,27.41,"Census Tract 803, Unicoi County, Tennessee",2516,119,4.73,2397,28.55,"Census Tract 803, Unicoi County, Tennessee",2543,155,6.1,2388,34.35
1460,47171080100,"Census Tract 801, Unicoi County, Tennessee",998,33,3.31,965,28.76,"Census Tract 801, Unicoi County, Tennessee",994,28,2.82,966,28.84,"Census Tract 801, Unicoi County, Tennessee",958,77,8.04,881,29.18
1461,47171080400,"Census Tract 804, Unicoi County, Tennessee",1237,39,3.15,1198,24.17,"Census Tract 804, Unicoi County, Tennessee",1171,18,1.54,1153,22.57,"Census Tract 804, Unicoi County, Tennessee",1444,40,2.77,1404,24.81
1462,47097050503,"Census Tract 505.03, Lauderdale County, Tennessee",1036,22,2.12,1014,31.46,"Census Tract 505.03, Lauderdale County, Tennessee",1001,19,1.9,982,29.85,"Census Tract 505.03, Lauderdale County, Tennessee",1036,13,1.25,1023,29.36
1463,47097050504,"Census Tract 505.04, Lauderdale County, Tennessee",1095,5,0.46,1090,25.02,"Census Tract 505.04, Lauderdale County, Tennessee",1014,8,0.79,1006,28.45,"Census Tract 505.04, Lauderdale County, Tennessee",963,25,2.6,938,30.72
1464,47097050505,"Census Tract 505.05, Lauderdale County, Tennessee",868,7,0.81,861,27.14,"Census Tract 505.05, Lauderdale County, Tennessee",1034,7,0.68,1027,24.78,"Census Tract 505.05, Lauderdale County, Tennessee",1132,0,0.0,1132,25.38
1465,47167040304,"Census Tract 403.04, Tipton County, Tennessee",2621,49,1.87,2572,43.54,"Census Tract 403.04, Tipton County, Tennessee",2878,25,0.87,2853,49.19,"Census Tract 403.04, Tipton County, Tennessee",2778,31,1.12,2747,47.8
1466,47129110300,"Census Tract 1103, Morgan County, Tennessee",1110,20,1.8,1090,37.58,"Census Tract 1103, Morgan County, Tennessee",1319,26,1.97,1293,34.22,"Census Tract 1103, Morgan County, Tennessee",1575,51,3.24,1524,28.82
1467,47129110100,"Census Tract 1101, Morgan County, Tennessee",895,50,5.59,845,40.07,"Census Tract 1101, Morgan County, Tennessee",941,20,2.13,921,37.91,"Census Tract 1101, Morgan County, Tennessee",969,53,5.47,916,38.34
1468,47129110500,"Census Tract 1105, Morgan County, Tennessee",1812,24,1.32,1788,36.28,"Census Tract 1105, Morgan County, Tennessee",1742,33,1.89,1709,37.92,"Census Tract 1105, Morgan County, Tennessee",1875,74,3.95,1801,36.07
1469,47129110200,"Census Tract 1102, Morgan County, Tennessee",1173,13,1.11,1160,42.16,"Census Tract 1102, Morgan County, Tennessee",1139,6,0.53,1133,43.62,"Census Tract 1102, Morgan County, Tennessee",1238,34,2.75,1204,41.81
1470,47129110400,"Census Tract 1104, Morgan County, Tennessee",1735,29,1.67,1706,33.28,"Census Tract 1104, Morgan County, Tennessee",1744,33,1.89,1711,31.66,"Census Tract 1104, Morgan County, Tennessee",1521,63,4.14,1458,31.5
1471,47103975000,"Census Tract 9750, Lincoln County, Tennessee",698,20,2.87,678,33.91,"Census Tract 9750, Lincoln County, Tennessee",732,42,5.74,690,33.67,"Census Tract 9750, Lincoln County, Tennessee",785,69,8.79,716,38.63
1472,47157005600,"Census Tract 56, Shelby County, Tennessee",1326,0,0.0,1326,24.2,"Census Tract 56, Shelby County, Tennessee",1294,0,0.0,1294,25.91,"Census Tract 56, Shelby County, Tennessee",1535,0,0.0,1535,29.33
1473,47157005800,"Census Tract 58, Shelby County, Tennessee",264,0,0.0,264,31.77,"Census Tract 58, Shelby County, Tennessee",292,0,0.0,292,34.25,"Census Tract 58, Shelby County, Tennessee",258,0,0.0,258,33.69
1474,47157005900,"Census Tract 59, Shelby County, Tennessee",708,0,0.0,708,23.89,"Census Tract 59, Shelby County, Tennessee",806,0,0.0,806,28.46,"Census Tract 59, Shelby County, Tennessee",629,0,0.0,629,31.13
1475,47103975700,"Census Tract 9757, Lincoln County, Tennessee",1359,50,3.68,1309,41.08,"Census Tract 9757, Lincoln County, Tennessee",1378,79,5.73,1299,39.27,"Census Tract 9757, Lincoln County, Tennessee",1447,28,1.94,1419,43.77
1476,47103975200,"Census Tract 9752, Lincoln County, Tennessee",936,28,2.99,908,39.77,"Census Tract 9752, Lincoln County, Tennessee",870,12,1.38,858,36.73,"Census Tract 9752, Lincoln County, Tennessee",826,13,1.57,813,37.14
1477,47103975100,"Census Tract 9751, Lincoln County, Tennessee",1031,27,2.62,1004,35.13,"Census Tract 9751, Lincoln County, Tennessee",1030,21,2.04,1009,34.73,"Census Tract 9751, Lincoln County, Tennessee",1090,19,1.74,1071,34.25
1478,47103975500,"Census Tract 9755, Lincoln County, Tennessee",1820,37,2.03,1783,38.76,"Census Tract 9755, Lincoln County, Tennessee",1933,37,1.91,1896,37.47,"Census Tract 9755, Lincoln County, Tennessee",2050,134,6.54,1916,38.61
1479,47103975400,"Census Tract 9754, Lincoln County, Tennessee",1622,29,1.79,1593,29.87,"Census Tract 9754, Lincoln County, Tennessee",1501,17,1.13,1484,27.18,"Census Tract 9754, Lincoln County, Tennessee",1619,15,0.93,1604,24.45
1480,47103975300,"Census Tract 9753, Lincoln County, Tennessee",2184,12,0.55,2172,26.69,"Census Tract 9753, Lincoln County, Tennessee",2228,35,1.57,2193,30.45,"Census Tract 9753, Lincoln County, Tennessee",2398,97,4.05,2301,33.26
1481,47073050503,"Census Tract 505.03, Hawkins County, Tennessee",1738,61,3.51,1677,26.35,"Census Tract 505.03, Hawkins County, Tennessee",1974,21,1.06,1953,26.31,"Census Tract 505.03, Hawkins County, Tennessee",2076,49,2.36,2027,28.56
1482,47157006000,"Census Tract 60, Shelby County, Tennessee",482,3,0.62,479,26.99,"Census Tract 60, Shelby County, Tennessee",574,4,0.7,570,29.73,"Census Tract 60, Shelby County, Tennessee",481,0,0.0,481,32.43
1483,47157006200,"Census Tract 62, Shelby County, Tennessee",875,28,3.2,847,25.51,"Census Tract 62, Shelby County, Tennessee",618,0,0.0,618,27.43,"Census Tract 62, Shelby County, Tennessee",563,24,4.26,539,28.08
1484,47157022111,"Census Tract 221.11, Shelby County, Tennessee",1767,0,0.0,1767,30.17,"Census Tract 221.11, Shelby County, Tennessee",1773,27,1.52,1746,28.15,"Census Tract 221.11, Shelby County, Tennessee",2037,28,1.37,2009,22.07
1485,47157022022,"Census Tract 220.22, Shelby County, Tennessee",1076,0,0.0,1076,30.17,"Census Tract 220.22, Shelby County, Tennessee",1186,0,0.0,1186,26.92,"Census Tract 220.22, Shelby County, Tennessee",1650,30,1.82,1620,24.07
1486,47165020700,"Census Tract 207, Sumner County, Tennessee",1462,79,5.4,1383,29.91,"Census Tract 207, Sumner County, Tennessee",1599,135,8.44,1464,30.96,"Census Tract 207, Sumner County, Tennessee",1984,175,8.82,1809,29.21
1487,47157006400,"Census Tract 64, Shelby County, Tennessee",611,8,1.31,603,22.06,"Census Tract 64, Shelby County, Tennessee",709,38,5.36,671,23.46,"Census Tract 64, Shelby County, Tennessee",998,38,3.81,960,24.51
1488,47157007400,"Census Tract 74, Shelby County, Tennessee",1947,52,2.67,1895,22.07,"Census Tract 74, Shelby County, Tennessee",1866,44,2.36,1822,22.23,"Census Tract 74, Shelby County, Tennessee",1769,48,2.71,1721,21.84
1489,47157007500,"Census Tract 75, Shelby County, Tennessee",367,0,0.0,367,28.97,"Census Tract 75, Shelby County, Tennessee",480,0,0.0,480,28.4,"Census Tract 75, Shelby County, Tennessee",485,0,0.0,485,24.47
1490,47157022310,"Census Tract 223.10, Shelby County, Tennessee",1637,16,0.98,1621,34.22,"Census Tract 223.10, Shelby County, Tennessee",1702,21,1.23,1681,32.8,"Census Tract 223.10, Shelby County, Tennessee",1333,0,0.0,1333,34.32
1491,47157022321,"Census Tract 223.21, Shelby County, Tennessee",1308,0,0.0,1308,28.87,"Census Tract 223.21, Shelby County, Tennessee",1320,0,0.0,1320,28.07,"Census Tract 223.21, Shelby County, Tennessee",1307,0,0.0,1307,29.19
1492,47157022112,"Census Tract 221.12, Shelby County, Tennessee",2647,44,1.66,2603,27.8,"Census Tract 221.12, Shelby County, Tennessee",2803,49,1.75,2754,30.09,"Census Tract 221.12, Shelby County, Tennessee",3176,30,0.94,3146,26.97
1493,47073050501,"Census Tract 505.01, Hawkins County, Tennessee",1701,16,0.94,1685,29.22,"Census Tract 505.01, Hawkins County, Tennessee",1523,36,2.36,1487,34.49,"Census Tract 505.01, Hawkins County, Tennessee",1502,44,2.93,1458,33.86
1494,47073050601,"Census Tract 506.01, Hawkins County, Tennessee",2317,59,2.55,2258,23.6,"Census Tract 506.01, Hawkins County, Tennessee",2500,65,2.6,2435,22.32,"Census Tract 506.01, Hawkins County, Tennessee",2550,56,2.2,2494,26.23
1495,47073050602,"Census Tract 506.02, Hawkins County, Tennessee",1739,49,2.82,1690,27.2,"Census Tract 506.02, Hawkins County, Tennessee",1840,58,3.15,1782,25.46,"Census Tract 506.02, Hawkins County, Tennessee",1864,164,8.8,1700,25.48
1496,47073050502,"Census Tract 505.02, Hawkins County, Tennessee",1066,41,3.85,1025,34.01,"Census Tract 505.02, Hawkins County, Tennessee",948,7,0.74,941,29.87,"Census Tract 505.02, Hawkins County, Tennessee",1121,15,1.34,1106,28.67
